Flow id,Src IP,Dst IP,Dst port,Protocol,Application protocol,Duration,Received bytes,Received packets,Transmitted bytes,Transmitted packets,Total bytes,Total packets,label,family
-7997503990174526411,10.127.0.165,93.184.221.240,80,tcp,-,680029,541,6,10262,212,10803,218,malware,smokeloader
478566816080830021,10.127.0.165,8.8.8.8,53,udp,dns,42386,37139,266,20026,281,57165,547,normal,-
-675404047921399113,10.127.0.165,109.206.243.140,80,tcp,http,93282,172869,181,14782,174,187651,355,malware,smokeloader
5403278567723867466,10.127.0.165,8.241.130.254,80,tcp,-,-1,0,0,0,0,0,0,malware,smokeloader
3227825145092506608,10.127.0.173,8.8.8.8,53,udp,dns,4055,16878,119,8476,119,25354,238,normal,-
-10607459132686212,10.127.0.173,109.206.243.140,80,tcp,-,92330,170642,158,11298,144,181940,302,malware,smokeloader
-7907694848595181361,10.127.0.173,13.69.109.130,443,tcp,-,113716,0,0,1932,42,1932,42,malware,smokeloader
-5900857944723415754,10.127.0.173,8.238.22.254,80,tcp,-,356182,0,0,6056,131,6056,131,malware,smokeloader
-1835785744146960604,10.127.0.173,173.223.113.164,443,tcp,-,170584,0,0,2898,63,2898,63,malware,smokeloader
3526884559142862594,10.127.0.124,8.238.21.126,80,tcp,-,329808,0,0,5610,120,5610,120,malware,smokeloader
8554825420131490939,10.127.0.124,8.8.8.8,53,udp,dns,16175,19810,148,10890,154,30700,302,normal,-
-6696025494967640272,10.127.0.124,109.206.243.140,80,tcp,-,91951,170882,164,11292,144,182174,308,malware,smokeloader
-4903096482558289378,10.127.0.124,40.77.2.164,443,tcp,-,30042,0,0,520,10,520,10,malware,smokeloader
6114951660946823823,10.127.0.124,93.184.220.29,80,tcp,-,246782,0,0,4186,91,4186,91,malware,smokeloader
2022311142570388140,10.127.0.124,131.253.33.203,80,tcp,-,190373,0,0,3220,70,3220,70,malware,smokeloader
-537168549953638133,10.127.0.124,173.223.113.164,443,tcp,-,94764,0,0,1610,35,1610,35,malware,smokeloader
-5109926421472652342,10.127.0.124,173.223.113.131,80,tcp,-,95281,0,0,1610,35,1610,35,malware,smokeloader
1771320969580383897,10.127.0.54,8.8.8.8,53,udp,dns,27691,17444,141,10600,152,28044,293,normal,-
8177793672851101525,10.127.0.54,209.197.3.8,80,tcp,-,18948,0,0,322,7,322,7,malware,smokeloader
-7801988881057781616,10.127.0.54,13.89.179.8,443,tcp,-,37897,0,0,644,14,644,14,malware,smokeloader
3710067482431243348,10.127.0.54,173.223.113.164,443,tcp,-,37904,0,0,644,14,644,14,malware,smokeloader
-4279369944134189121,10.127.0.54,173.223.113.131,80,tcp,-,37904,0,0,644,14,644,14,malware,smokeloader
-3292904007637023371,10.127.0.54,204.79.197.203,80,tcp,-,37904,0,0,644,14,644,14,malware,smokeloader
5890331262372161152,10.127.0.54,52.152.108.96,443,tcp,-,30046,0,0,520,10,520,10,malware,smokeloader
4340993545494410278,10.127.0.54,185.246.221.154,80,tcp,http,1488,362,4,839,6,1201,10,malware,smokeloader
3900716111130487516,10.127.0.53,8.8.8.8,53,udp,dns,17364,8403,60,4633,65,13036,125,normal,-
-2785428747266266595,10.127.0.53,185.246.221.154,80,tcp,http,111,362,4,826,6,1188,10,malware,smokeloader
-6385591296429922664,10.127.0.53,8.238.179.126,80,tcp,-,37904,0,0,644,14,644,14,malware,smokeloader
-3416354810329433525,10.127.0.53,173.223.113.164,443,tcp,-,94779,0,0,1610,35,1610,35,malware,smokeloader
-1385788627015344366,10.127.0.53,173.223.113.131,80,tcp,-,94784,0,0,1610,35,1610,35,malware,smokeloader
6637762124484823497,10.127.0.53,131.253.33.203,80,tcp,-,37904,0,0,644,14,644,14,malware,smokeloader
-2329966853016160903,10.127.0.53,13.107.42.16,443,tcp,-,37949,0,0,644,14,644,14,malware,smokeloader
6364342567972475301,10.127.0.74,209.197.3.8,80,tcp,-,75828,0,0,1288,28,1288,28,malware,smokeloader
9140961908657019912,10.127.0.74,117.18.237.29,80,tcp,-,99857,0,0,644,14,644,14,malware,smokeloader
-42130135298242327,10.127.0.74,8.8.8.8,53,udp,dns,8154,6540,48,3415,48,9955,96,normal,-
-8705611137309767180,10.127.0.74,52.168.112.66,443,tcp,-,37920,0,0,644,14,644,14,malware,smokeloader
-5105741024537709539,10.127.0.74,173.223.113.164,443,tcp,-,74903,0,0,1196,26,1196,26,malware,smokeloader
5101402168576793522,10.127.0.74,185.246.221.154,80,tcp,http,67,384,4,694,6,1078,10,malware,smokeloader
7661340243330840740,10.127.0.74,93.184.221.240,80,tcp,-,37937,0,0,644,14,644,14,malware,smokeloader
-1185094612700716948,10.127.0.66,209.197.3.8,80,tcp,-,291437,0,0,4966,106,4966,106,malware,smokeloader
5124601559930294338,10.127.0.66,8.8.8.8,53,udp,dns,19304,17272,127,9277,132,26549,259,normal,-
4811889370831200523,10.127.0.66,52.182.143.210,443,tcp,-,94753,0,0,1610,35,1610,35,malware,smokeloader
-6985038617944029699,10.127.0.66,173.223.113.164,443,tcp,-,132690,0,0,2254,49,2254,49,malware,smokeloader
3472268029200089448,10.127.0.66,173.223.113.131,80,tcp,-,132697,0,0,2254,49,2254,49,malware,smokeloader
4458733965697255198,10.127.0.66,204.79.197.203,80,tcp,-,132695,0,0,2254,49,2254,49,malware,smokeloader
-6354112554880862769,10.127.0.66,185.246.221.154,80,tcp,http,172,362,4,657,6,1019,10,malware,smokeloader
-102717902272118026,10.127.0.62,20.189.173.2,443,tcp,-,58321,0,0,966,21,966,21,malware,smokeloader
-5379031871078884918,10.127.0.62,209.197.3.8,80,tcp,-,132648,0,0,2254,49,2254,49,malware,smokeloader
-7757121493503940686,10.127.0.62,8.8.8.8,53,udp,dns,4153,15813,112,7849,112,23662,224,normal,-
-1420017597668713107,10.127.0.62,173.223.113.164,443,tcp,-,56857,0,0,966,21,966,21,malware,smokeloader
-8422989087736979826,10.127.0.62,204.79.197.203,80,tcp,-,56875,0,0,966,21,966,21,malware,smokeloader
-5913310456053263518,10.127.0.62,8.238.177.126,80,tcp,-,56861,0,0,966,21,966,21,malware,smokeloader
760246182272204697,10.127.0.62,52.152.108.96,443,tcp,-,45103,0,0,780,15,780,15,malware,smokeloader
-3532450290910952844,10.127.0.62,104.21.18.99,80,tcp,-,15046,0,0,260,5,260,5,malware,smokeloader
-1633491286696134646,10.127.0.62,172.67.181.144,80,tcp,-,14999,0,0,260,5,260,5,malware,smokeloader
-3533983201770195093,10.127.0.62,91.195.240.101,80,tcp,http,15267,1555,16,2331,21,3886,37,malware,smokeloader
7872890198668894417,10.127.0.62,199.59.243.222,80,tcp,http,20218,1772,8,753,8,2525,16,malware,smokeloader
1978362335738556061,10.127.0.65,8.8.8.8,53,udp,dns,10752,17125,121,8579,121,25704,242,normal,-
-5594274236288137004,10.127.0.65,185.246.221.154,80,tcp,http,113,362,4,824,6,1186,10,malware,smokeloader
-8210711643825132712,10.127.0.65,40.79.141.153,443,tcp,-,75815,0,0,1288,28,1288,28,malware,smokeloader
-1383607535505343620,10.127.0.65,52.152.110.14,443,tcp,-,776750,0,0,13624,262,13624,262,malware,smokeloader
-5712045012087628388,10.127.0.65,209.197.3.8,80,tcp,-,151664,0,0,2576,56,2576,56,malware,smokeloader
-5781413819523118437,10.127.0.65,173.223.113.164,443,tcp,-,170642,0,0,2898,63,2898,63,malware,smokeloader
-6217761116392695501,10.127.0.65,20.54.89.15,443,tcp,-,60099,0,0,1040,20,1040,20,malware,smokeloader
-3011741431243914310,10.127.0.99,152.195.38.76,80,tcp,-,2,80,2,92,2,172,4,malware,smokeloader
-520990415756303693,10.127.0.99,93.184.221.240,80,tcp,-,235120,40,1,4046,86,4086,87,malware,smokeloader
5823925896339796728,10.127.0.99,8.8.8.8,53,udp,dns,19232,15340,107,8516,117,23856,224,normal,-
-3218894083382698023,10.127.0.99,109.206.243.140,80,tcp,http,43924,216148,493,70913,590,287061,1083,malware,smokeloader
-3810320270714060501,10.127.0.99,13.78.111.198,443,tcp,-,144121,0,0,1610,35,1610,35,malware,smokeloader
3600808501867938798,10.127.0.99,51.91.79.17,443,tcp,http,75217,7428,13,976,11,8404,24,malware,smokeloader
-849807891891683404,10.127.0.99,138.91.171.81,80,tcp,-,0,40,1,46,1,86,2,malware,smokeloader
5759141225268190994,10.127.0.99,204.79.197.203,443,tcp,-,0,40,1,0,0,40,1,malware,smokeloader
-3268068073745332344,10.127.0.99,173.223.113.164,443,tcp,-,95139,0,0,1610,35,1610,35,malware,smokeloader
714985816358885292,10.127.0.99,52.109.77.1,443,tcp,-,0,40,1,0,0,40,1,malware,smokeloader
7056600268255107509,10.127.0.62,93.184.220.29,80,tcp,-,30061,0,0,520,10,520,10,malware,smokeloader
403928958388052242,10.127.0.62,52.152.110.14,443,tcp,-,749670,0,0,13312,256,13312,256,malware,smokeloader
-5325414510462261417,10.127.0.62,109.206.243.140,80,tcp,http,41724,16180,31,2996,32,19176,63,malware,smokeloader
-2076997628298204419,10.127.0.170,8.8.8.8,53,udp,dns,20733,12622,91,6817,96,19439,187,normal,-
-3935822726513495233,10.127.0.170,185.246.221.154,80,tcp,http,212,362,4,704,6,1066,10,malware,smokeloader
-7140608517537671631,10.127.0.170,173.223.113.164,443,tcp,-,95206,0,0,1610,35,1610,35,malware,smokeloader
5890557857567456984,10.127.0.170,173.223.113.131,80,tcp,-,56852,0,0,966,21,966,21,malware,smokeloader
5487368145237594859,10.127.0.170,131.253.33.203,80,tcp,-,57211,0,0,966,21,966,21,malware,smokeloader
1714039850088846723,10.127.0.170,8.238.20.126,80,tcp,-,56857,0,0,966,21,966,21,malware,smokeloader
-2675864652068521982,10.127.0.182,8.8.8.8,53,udp,dns,34935,24904,195,14223,205,39127,400,normal,-
5056351482398613663,10.127.0.182,185.246.221.154,80,tcp,http,4127,362,4,890,6,1252,10,malware,smokeloader
4246403791902335700,10.127.0.182,40.79.189.59,443,tcp,-,124521,0,0,1288,28,1288,28,malware,smokeloader
-4721829333518794229,10.127.0.182,173.223.113.164,443,tcp,-,171049,0,0,2898,63,2898,63,malware,smokeloader
-6939922936562244553,10.127.0.182,52.152.108.96,443,tcp,-,60099,0,0,1040,20,1040,20,malware,smokeloader
-6802071435711228875,10.127.0.182,93.184.221.240,80,tcp,-,223510,0,0,3802,82,3802,82,malware,smokeloader
-3564012007229985736,10.127.0.182,173.223.113.131,80,tcp,-,246836,0,0,4186,91,4186,91,malware,smokeloader
-2577546070732819986,10.127.0.182,204.79.197.203,80,tcp,-,171289,0,0,2898,63,2898,63,malware,smokeloader
4581397748899391290,10.127.0.68,8.253.208.120,80,tcp,-,151982,0,0,2576,56,2576,56,malware,smokeloader
1482831380968824627,10.127.0.68,93.184.220.29,80,tcp,-,75777,120,3,1426,31,1546,34,malware,smokeloader
-8932532997805855440,10.127.0.68,8.8.8.8,53,udp,dns,5177,17493,130,8996,130,26489,260,normal,-
-4511094907960210242,10.127.0.68,172.67.181.144,80,tcp,http,109986,3232801,2479,71059,1287,3303860,3766,malware,smokeloader
-1434645692205515829,10.127.0.68,187.245.185.123,80,tcp,http,11567,2902854,2095,74337,1581,2977191,3676,malware,smokeloader
4356593934709271507,10.127.0.68,45.9.74.80,80,tcp,http,184598,45205437,32307,1494533,31929,46699970,64236,malware,smokeloader
6685817893313138735,10.127.0.68,162.0.217.254,443,tcp,http,128095,49137,66,6326,89,55463,155,malware,smokeloader
-7387382432975087653,10.127.0.68,52.152.108.96,443,tcp,-,60175,0,0,1040,20,1040,20,malware,smokeloader
4754538045577437517,10.127.0.68,79.137.206.226,80,tcp,http,5274,204232,157,7705,151,211937,308,malware,smokeloader
6122367776309233543,10.127.0.68,51.105.71.136,443,tcp,-,76100,0,0,1288,28,1288,28,malware,smokeloader
4551640006553513062,10.127.0.68,161.97.179.222,443,tcp,tls,65220,209474,159,4339,84,213813,243,malware,smokeloader
-6506831469825470416,10.127.0.68,45.136.113.107,80,tcp,http,109748,1582775,1644,53391,1121,1636166,2765,malware,smokeloader
4497306340105517073,10.127.0.68,89.190.157.61,80,tcp,http,5491,280128,204,5333,111,285461,315,malware,smokeloader
1976922712802203161,10.127.0.68,58.235.189.192,80,tcp,http,3745,11429,16,1059,18,12488,34,malware,smokeloader
1359828687789746646,10.127.0.68,104.21.8.227,443,tcp,tls,15839,1329217,1163,29084,605,1358301,1768,malware,smokeloader
1151258961033258822,10.127.0.68,77.73.134.27,80,tcp,http,124736,1397221,5773,920537,19997,2317758,25770,malware,smokeloader
-2442728082336238147,10.127.0.68,157.240.221.35,443,tcp,tls,27252,158205,124,7019,68,165224,192,normal,-
-5864571642531335329,10.127.0.68,149.154.167.99,443,tcp,tls,48494,58215,61,4784,72,62999,133,malware,smokeloader
-3181045192893110437,10.127.0.68,45.66.159.179,80,tcp,http,86855,1538,10,2294,14,3832,24,malware,smokeloader
-6993786484954995989,10.127.0.68,173.223.113.164,443,tcp,-,76252,0,0,1288,28,1288,28,malware,smokeloader
-3059182263773698275,10.127.0.68,95.216.179.190,80,tcp,http,40490,8301485,6050,735960,6283,9037445,12333,malware,smokeloader
-1337709934178901557,10.127.0.68,37.34.248.24,80,tcp,http,2101,20910,22,1292,24,22202,46,malware,smokeloader
-5168608199940721597,10.127.0.68,109.206.243.140,80,tcp,http,53547,190765,369,44146,382,234911,751,malware,smokeloader
4073819306118137236,10.127.0.68,211.119.84.112,80,tcp,http,42473,16427,110,17046,132,33473,242,malware,smokeloader
7813384184801772697,10.127.0.68,173.223.113.131,80,tcp,-,76200,80,2,1720,30,1800,32,malware,smokeloader
4449986098686288908,10.127.0.68,204.79.197.203,80,tcp,-,75889,0,0,1288,28,1288,28,malware,smokeloader
9010298398267535689,10.127.0.68,190.211.254.211,80,tcp,http,65130,317694,294,5590,118,323284,412,malware,smokeloader
-3353271213361964512,10.127.0.68,45.159.189.105,80,tcp,http,60009,4440,14,1938,22,6378,36,malware,smokeloader
1571783030549470585,10.127.0.68,80.66.64.210,80,tcp,http,6929,31769,627,1310732,886,1342501,1513,malware,smokeloader
-3058851998569835034,10.127.0.68,104.26.13.31,443,tcp,tls,16119,8528,17,1466,17,9994,34,malware,smokeloader
6478414145491378521,10.127.0.68,51.91.79.17,443,tcp,tls,119,4905,7,767,7,5672,14,malware,smokeloader
4294014112794212286,10.127.0.106,209.197.3.8,80,tcp,-,150928,0,0,2588,53,2588,53,malware,smokeloader
-2112458590476505342,10.127.0.106,8.8.8.8,53,udp,dns,17830,6019,42,3685,52,9704,94,normal,-
-2726799704764783061,10.127.0.106,93.184.221.240,80,tcp,-,75794,0,0,1288,28,1288,28,malware,smokeloader
-2777031466740688694,10.127.0.106,109.206.243.140,80,tcp,http,39652,6920,22,2648,25,9568,47,malware,smokeloader
-2778263195698197737,10.127.0.106,52.152.110.14,443,tcp,-,344664,0,0,6136,118,6136,118,malware,smokeloader
8675890098836069877,10.127.0.106,104.208.16.88,443,tcp,-,75809,0,0,1288,28,1288,28,malware,smokeloader
4224645305358722237,10.127.0.106,173.223.113.164,443,tcp,-,75808,0,0,1288,28,1288,28,malware,smokeloader
4857970186338592767,10.127.0.77,8.8.8.8,53,udp,dns,18197,16585,115,8978,125,25563,240,normal,-
2865520682722073371,10.127.0.77,20.189.173.6,443,tcp,-,75810,0,0,1288,28,1288,28,malware,smokeloader
-694358060648004495,10.127.0.77,109.206.243.140,80,tcp,http,62647,226758,538,76185,630,302943,1168,malware,smokeloader
-8686352799798699498,10.127.0.113,52.152.110.14,443,tcp,-,24008,0,0,312,6,312,6,malware,smokeloader
4695620681324721811,10.127.0.113,8.8.8.8,53,udp,dns,28270,18173,126,9702,136,27875,262,normal,-
-1614075491306289475,10.127.0.113,209.197.3.8,80,tcp,-,412978,0,0,7034,149,7034,149,malware,smokeloader
1521341492282396874,10.127.0.113,185.246.221.154,80,tcp,http,184,362,4,859,6,1221,10,malware,smokeloader
-7414019496549602226,10.127.0.113,173.223.113.164,443,tcp,-,56873,0,0,966,21,966,21,malware,smokeloader
3672662146550892862,10.127.0.76,88.221.25.155,80,tcp,-,56829,0,0,966,21,966,21,malware,smokeloader
-609727465031050943,10.127.0.76,8.8.8.8,53,udp,dns,1284,6837,48,3493,49,10330,97,normal,-
2980686635600922243,10.127.0.76,47.253.32.167,80,tcp,http,32297,466357,352,10847,201,477204,553,malware,smokeloader
2105750123331637971,10.127.0.76,20.189.173.5,443,tcp,-,57070,0,0,966,21,966,21,malware,smokeloader
8745022638593371601,10.127.0.76,173.223.113.164,443,tcp,-,76230,0,0,1288,28,1288,28,malware,smokeloader
-1497874820192514697,10.127.0.76,173.223.113.131,80,tcp,-,76387,0,0,1288,28,1288,28,malware,smokeloader
9187113784417185002,10.127.0.76,204.79.197.203,80,tcp,-,76387,0,0,1288,28,1288,28,malware,smokeloader
-9092211511580342915,10.127.0.76,178.79.208.1,80,tcp,-,56837,0,0,966,21,966,21,malware,smokeloader
3469579844625459436,10.127.0.64,52.109.8.44,443,tcp,-,0,40,1,0,0,40,1,malware,smokeloader
8130208477240538172,10.127.0.64,192.229.221.95,80,tcp,-,0,40,1,46,1,86,2,malware,smokeloader
1613708393958312474,10.127.0.64,209.197.3.8,80,tcp,-,158774,0,0,2712,57,2712,57,malware,smokeloader
-6593924276405964304,10.127.0.64,20.44.10.123,443,tcp,-,18953,0,0,322,7,322,7,malware,smokeloader
-9191121692296773282,10.127.0.64,8.8.8.8,53,udp,dns,952,7465,54,3766,54,11231,108,normal,-
8589817776191085939,10.127.0.64,52.152.110.14,443,tcp,-,135202,0,0,2340,45,2340,45,malware,smokeloader
4192011492173311122,10.127.0.64,173.223.113.164,443,tcp,-,94775,0,0,1610,35,1610,35,malware,smokeloader
4017611003638665041,10.127.0.64,173.223.113.131,80,tcp,-,94763,0,0,1610,35,1610,35,malware,smokeloader
605719557151462663,10.127.0.64,204.79.197.203,80,tcp,-,18952,0,0,322,7,322,7,malware,smokeloader
8101651517410549200,10.127.0.64,109.206.243.140,80,tcp,http,44799,216348,498,70356,587,286704,1085,malware,smokeloader
6268318811372179268,10.127.0.64,51.91.79.17,443,tcp,http,7634,7239,9,859,9,8098,18,malware,smokeloader
-8512626020587573704,10.127.0.185,8.8.8.8,53,udp,dns,18535,9421,68,5208,73,14629,141,normal,-
-3798056093909633024,10.127.0.185,185.246.221.154,80,tcp,http,19107,362,4,807,6,1169,10,malware,smokeloader
-8335610798723857307,10.127.0.185,52.152.110.14,443,tcp,-,181338,0,0,3224,62,3224,62,malware,smokeloader
-1228600910554011678,10.127.0.185,13.89.178.26,443,tcp,-,37906,0,0,644,14,644,14,malware,smokeloader
-6375563265267168290,10.127.0.185,117.18.237.29,80,tcp,-,120533,0,0,904,19,904,19,malware,smokeloader
38744033447058223,10.127.0.185,209.197.3.8,80,tcp,-,200611,0,0,3418,73,3418,73,malware,smokeloader
-5761199971796254528,10.127.0.185,173.223.113.164,443,tcp,-,56857,0,0,966,21,966,21,malware,smokeloader
297749292363496491,10.127.0.185,173.223.113.131,80,tcp,-,56857,0,0,966,21,966,21,malware,smokeloader
1284215228860662241,10.127.0.185,204.79.197.203,80,tcp,-,56850,0,0,966,21,966,21,malware,smokeloader
-1370323528395240145,10.127.0.73,209.197.3.8,80,tcp,-,204681,0,0,3480,75,3480,75,malware,smokeloader
6809481807168990086,10.127.0.73,8.8.8.8,53,udp,dns,3513,13139,94,6783,96,19922,190,normal,-
3167499516401685980,10.127.0.73,20.189.173.3,443,tcp,-,56889,0,0,966,21,966,21,malware,smokeloader
1745870917929522874,10.127.0.73,173.223.113.164,443,tcp,-,56859,0,0,966,21,966,21,malware,smokeloader
190759254199703630,10.127.0.73,173.223.113.131,80,tcp,-,56843,0,0,966,21,966,21,malware,smokeloader
-1840421017092325585,10.127.0.73,204.79.197.203,80,tcp,-,56842,0,0,966,21,966,21,malware,smokeloader
5655510943166760952,10.127.0.73,109.206.243.140,80,tcp,http,50632,12316,18,1329,18,13645,36,malware,smokeloader
-8630895311419828871,10.127.0.167,8.8.8.8,53,udp,dns,58198,32759,232,17627,247,50386,479,normal,-
3129703903892968634,10.127.0.167,185.246.221.154,80,tcp,http,8426,724,8,1635,12,2359,20,malware,smokeloader
6440391510037435680,10.127.0.167,20.189.173.9,443,tcp,-,85435,0,0,1288,28,1288,28,malware,smokeloader
-3242963258339019406,10.127.0.191,8.8.8.8,53,udp,dns,34993,40381,309,22138,314,62519,623,normal,-
-6970793850302258008,10.127.0.191,109.206.243.140,80,tcp,http,102208,359547,495,53669,504,413216,999,malware,smokeloader
-1496820900652394248,10.127.0.191,20.42.73.26,443,tcp,-,37905,0,0,644,14,644,14,malware,smokeloader
-2996028130073219649,10.127.0.191,209.197.3.8,80,tcp,-,113715,0,0,1932,42,1932,42,malware,smokeloader
-8306574147578486618,10.127.0.191,173.223.113.164,443,tcp,-,190072,0,0,3220,70,3220,70,malware,smokeloader
3980018263148207071,10.127.0.191,204.79.197.203,80,tcp,-,37905,0,0,644,14,644,14,malware,smokeloader
-660823849966571235,10.127.0.58,8.8.8.8,53,udp,dns,8178,2131,17,1190,17,3321,34,normal,-
4053746076711369445,10.127.0.58,185.246.221.154,80,tcp,http,144,362,4,670,6,1032,10,malware,smokeloader
4466169591910167529,10.127.0.58,20.189.173.13,443,tcp,-,18951,0,0,322,7,322,7,malware,smokeloader
-537438455049052001,10.127.0.165,185.246.221.154,80,tcp,http,2095,362,4,858,6,1220,10,malware,smokeloader
4494860649069688679,10.127.0.51,8.8.8.8,53,udp,dns,82711,8241,65,4555,65,12796,130,normal,-
767030057106450077,10.127.0.51,109.206.243.140,80,tcp,http,9703,216824,501,71678,588,288502,1089,malware,smokeloader
-9050337878960196386,10.127.0.51,51.91.79.17,443,tcp,http,75145,7429,13,1022,12,8451,25,malware,smokeloader
-2623955630555438958,10.127.0.51,20.189.173.4,443,tcp,-,56917,0,0,966,21,966,21,malware,smokeloader
-395532310141759350,10.127.0.51,93.184.221.240,80,tcp,-,56867,0,0,966,21,966,21,malware,smokeloader
-568750240169778533,10.127.0.51,173.223.113.164,443,tcp,-,57077,0,0,920,20,920,20,malware,smokeloader
-7715367839649802210,10.127.0.51,173.223.113.131,80,tcp,-,56895,0,0,966,21,966,21,malware,smokeloader
-7571721730238045252,10.127.0.51,204.79.197.203,80,tcp,-,56971,0,0,920,20,920,20,malware,smokeloader
-6305526951202206585,10.127.0.79,8.8.8.8,53,udp,dns,2611,6923,53,3735,53,10658,106,normal,-
1050066899272182720,10.127.0.79,8.248.1.254,80,tcp,-,52916,0,0,904,19,904,19,malware,smokeloader
7077606233267877819,10.127.0.79,173.223.113.164,443,tcp,-,37904,0,0,644,14,644,14,malware,smokeloader
5522494569538058575,10.127.0.79,173.223.113.131,80,tcp,-,37906,0,0,644,14,644,14,malware,smokeloader
-7909400486828665431,10.127.0.79,204.79.197.203,80,tcp,-,37905,0,0,644,14,644,14,malware,smokeloader
704594969235538409,10.127.0.79,172.67.181.144,80,tcp,http,80870,1645283,1264,38214,653,1683497,1917,malware,smokeloader
-3341882282389900642,10.127.0.79,203.91.116.53,80,tcp,-,24617,745838,539,15831,327,761669,866,malware,smokeloader
3576921270519047081,10.127.0.79,190.218.32.226,80,tcp,http,6104,746318,551,15231,306,761549,857,malware,smokeloader
-18757420777406301,10.127.0.79,45.9.74.80,80,tcp,http,221,325071,235,5856,123,330927,358,malware,smokeloader
6887324630615852163,10.127.0.79,79.137.206.226,80,tcp,http,5313,210536,161,7823,156,218359,317,malware,smokeloader
1822173255926275112,10.127.0.77,51.91.79.17,443,tcp,http,75119,7430,13,976,11,8406,24,malware,smokeloader
-2143006350698584499,10.127.0.77,13.69.109.131,443,tcp,-,56856,0,0,966,21,966,21,malware,smokeloader
-5885303508741875782,10.127.0.77,93.184.221.240,80,tcp,-,113765,120,3,2070,45,2190,48,malware,smokeloader
-7251669991535731270,10.127.0.77,173.223.113.164,443,tcp,-,56855,0,0,966,21,966,21,malware,smokeloader
5241605035459632974,10.127.0.77,173.223.113.131,80,tcp,-,56860,0,0,966,21,966,21,malware,smokeloader
-7605262345786457127,10.127.0.60,8.8.8.8,53,udp,dns,8602,13749,96,6654,94,20403,190,normal,-
-1198789642515739499,10.127.0.60,209.197.3.8,80,tcp,-,75804,0,0,1288,28,1288,28,malware,smokeloader
4798194341016177972,10.127.0.60,52.182.143.210,443,tcp,-,37905,0,0,644,14,644,14,malware,smokeloader
-1268158449951229548,10.127.0.60,173.223.113.164,443,tcp,-,132663,0,0,2254,49,2254,49,malware,smokeloader
8651256849083125228,10.127.0.60,173.223.113.131,80,tcp,-,132669,0,0,2254,49,2254,49,malware,smokeloader
-4780638207283598778,10.127.0.60,204.79.197.203,80,tcp,-,37904,0,0,644,14,644,14,malware,smokeloader
2853259345847834871,10.127.0.60,185.246.221.154,80,tcp,http,157,362,4,685,6,1047,10,malware,smokeloader
-2879691123604851335,10.127.0.182,104.21.18.99,80,tcp,http,109999,1859593,1431,47750,793,1907343,2224,malware,smokeloader
-5027209371015472188,10.127.0.182,203.91.116.53,80,tcp,http,21066,2704606,2002,77879,1618,2782485,3620,malware,smokeloader
-3435124410278578523,10.127.0.182,45.9.74.80,80,tcp,http,75277,325151,237,5814,123,330965,360,malware,smokeloader
3470957641114679941,10.127.0.182,79.137.206.226,80,tcp,http,5400,210536,161,9349,158,219885,319,malware,smokeloader
-341714276105970159,10.127.0.182,162.0.217.254,443,tcp,tls,150570,49248,68,6424,91,55672,159,malware,smokeloader
4619126815178617273,10.127.0.182,172.67.141.51,443,tcp,tls,5890,1322273,1006,26658,546,1348931,1552,malware,smokeloader
-3654215081239642095,10.127.0.182,175.120.254.9,80,tcp,http,10290,32344,38,2398,43,34742,81,malware,smokeloader
8652063142015901997,10.127.0.182,20.189.173.4,443,tcp,-,40874,0,0,644,14,644,14,malware,smokeloader
2351427597315867465,10.127.0.182,161.97.179.222,443,tcp,tls,65407,216331,164,4431,86,220762,250,malware,smokeloader
-8429948296951852687,10.127.0.182,172.64.155.188,80,tcp,http,1076,1583,4,386,5,1969,9,malware,smokeloader
-8064784051768980926,10.127.0.182,149.154.167.99,443,tcp,tls,61719,58177,60,4786,72,62963,132,malware,smokeloader
2335365493120655508,10.127.0.182,45.159.189.105,80,tcp,http,60779,2306,9,1110,14,3416,23,malware,smokeloader
34507219309687038,10.127.0.182,20.54.89.15,443,tcp,-,30970,0,0,520,10,520,10,malware,smokeloader
1786634615623512953,10.127.0.182,95.216.179.190,80,tcp,http,58293,8309845,6259,1253887,6644,9563732,12903,malware,smokeloader
2478844311041078397,10.127.0.182,117.18.237.29,80,tcp,-,119035,0,0,904,19,904,19,malware,smokeloader
-5967914616910338303,10.127.0.182,209.197.3.8,80,tcp,-,115819,0,0,1932,42,1932,42,malware,smokeloader
4918385889526266551,10.127.0.182,109.206.243.140,80,tcp,http,68750,217868,510,74540,613,292408,1123,malware,smokeloader
-4898982046540379912,10.127.0.182,51.91.79.17,443,tcp,tls,746,7335,10,923,10,8258,20,malware,smokeloader
-7996289130494840158,10.127.0.123,87.248.202.1,80,tcp,-,89232,0,0,1486,31,1486,31,malware,smokeloader
6203470046697083437,10.127.0.123,8.8.8.8,53,udp,dns,5162,14515,107,7454,107,21969,214,normal,-
-2659292378613713717,10.127.0.123,172.67.181.144,80,tcp,http,110053,1860025,1441,52856,824,1912881,2265,malware,smokeloader
3852125327750133231,10.127.0.123,203.91.116.53,80,tcp,http,20131,2705606,2027,74093,1538,2779699,3565,malware,smokeloader
5444210288487026896,10.127.0.123,45.9.74.80,80,tcp,http,75309,325151,237,6864,141,332015,378,malware,smokeloader
-3522592005868256788,10.127.0.123,79.137.206.226,80,tcp,http,5338,210536,161,7815,156,218351,317,malware,smokeloader
-1053420810022791199,10.127.0.123,162.0.217.254,443,tcp,http,138900,49248,68,6418,91,55666,159,malware,smokeloader
6452432225309365867,10.127.0.123,172.67.141.51,443,tcp,tls,5679,1327905,1133,27986,581,1355891,1714,malware,smokeloader
3814758705307909791,10.127.0.123,161.97.179.222,443,tcp,tls,65384,216331,164,4431,86,220762,250,malware,smokeloader
-1727871171297848637,10.127.0.123,187.212.215.20,80,tcp,http,5547,32340,38,2363,42,34703,80,malware,smokeloader
-3890876003949019386,10.127.0.123,20.189.173.12,443,tcp,-,57145,0,0,966,21,966,21,malware,smokeloader
814550646996624493,10.127.0.123,149.154.167.99,443,tcp,tls,85381,58175,60,4784,72,62959,132,malware,smokeloader
6267611931404750244,10.127.0.123,95.216.179.190,80,tcp,http,83546,8303165,6092,752770,6285,9055935,12377,malware,smokeloader
-7232043881823290689,10.127.0.123,45.159.189.105,80,tcp,http,61109,2306,9,1110,14,3416,23,malware,smokeloader
-6794298670476869678,10.127.0.123,93.184.220.29,80,tcp,-,72583,0,0,1226,26,1226,26,malware,smokeloader
5538897170432900085,10.127.0.123,109.206.243.140,80,tcp,http,33830,173824,190,15160,160,188984,350,malware,smokeloader
-7906384072794014368,10.127.0.177,8.8.8.8,53,udp,dns,12331,17686,135,9511,136,27197,271,normal,-
-6676737524905087556,10.127.0.177,117.18.232.240,80,tcp,-,596660,0,0,3864,84,3864,84,malware,smokeloader
6414153217272830355,10.127.0.177,93.184.221.240,80,tcp,-,306976,40,1,5272,112,5312,113,malware,smokeloader
-1076697541063242704,10.127.0.177,93.184.220.29,80,tcp,-,331677,991,6,4152,85,5143,91,malware,smokeloader
-8922389343923896390,10.127.0.177,185.246.221.154,80,tcp,-,15031,0,0,260,5,260,5,malware,smokeloader
6065097495163250726,10.127.0.177,40.79.141.153,443,tcp,-,76276,0,0,1288,28,1288,28,malware,smokeloader
1891071264632161633,10.127.0.177,173.223.113.164,443,tcp,-,133037,0,0,2254,49,2254,49,malware,smokeloader
-8794531427955478122,10.127.0.177,173.223.113.131,80,tcp,-,76262,0,0,1288,28,1288,28,malware,smokeloader
7546830816462050527,10.127.0.177,131.253.33.203,80,tcp,-,76263,0,0,1288,28,1288,28,malware,smokeloader
3730635054506258724,10.127.0.191,117.18.232.240,80,tcp,-,1254926,0,0,7728,168,7728,168,malware,smokeloader
-6832828257429910896,10.127.0.191,185.246.221.154,80,tcp,http,195,362,4,835,6,1197,10,malware,smokeloader
1406221524198544348,10.127.0.191,52.152.110.14,443,tcp,-,120433,0,0,2080,40,2080,40,malware,smokeloader
-3704272929652623400,10.127.0.191,13.69.239.74,443,tcp,-,151842,0,0,2576,56,2576,56,malware,smokeloader
2993552326651041321,10.127.0.191,173.223.113.131,80,tcp,-,152466,0,0,2576,56,2576,56,malware,smokeloader
-8810352170753515595,10.127.0.191,131.253.33.203,80,tcp,-,152140,0,0,2576,56,2576,56,malware,smokeloader
-4818605016426563253,10.127.0.163,8.238.177.126,80,tcp,-,192615,40,1,2346,51,2386,52,malware,smokeloader
-7721578637866734374,10.127.0.163,93.184.220.29,80,tcp,-,113644,0,0,1932,42,1932,42,malware,smokeloader
5276190079307218741,10.127.0.163,8.8.8.8,53,udp,dns,38086,28265,203,15702,223,43967,426,normal,-
-7278495569769705184,10.127.0.163,109.206.243.140,80,tcp,http,63438,218212,494,72441,602,290653,1096,malware,smokeloader
-7328220659098932816,10.127.0.163,52.152.110.14,443,tcp,-,172517,0,0,3068,59,3068,59,malware,smokeloader
-3798031384448438047,10.127.0.163,52.109.13.62,443,tcp,-,0,40,1,0,0,40,1,malware,smokeloader
8899915576000327633,10.127.0.163,52.168.112.66,443,tcp,-,37967,0,0,644,14,644,14,malware,smokeloader
-1168131985127421634,10.127.0.163,173.223.113.164,443,tcp,-,190181,0,0,3220,70,3220,70,malware,smokeloader
-1342532473662067715,10.127.0.163,173.223.113.131,80,tcp,-,152032,0,0,2576,56,2576,56,malware,smokeloader
3672316543680759895,10.127.0.163,204.79.197.203,80,tcp,-,152030,0,0,2576,56,2576,56,malware,smokeloader
-3919144426110016785,10.127.0.163,51.91.79.17,443,tcp,http,260,7239,9,813,8,8052,17,malware,smokeloader
6718189263501691023,10.127.0.160,93.184.221.240,80,tcp,-,33971,0,0,582,12,582,12,malware,smokeloader
-6838161850996412564,10.127.0.160,8.8.8.8,53,udp,dns,8136,1581,11,1158,16,2739,27,normal,-
-881130317949931073,10.127.0.160,40.74.98.192,443,tcp,-,22405,0,0,322,7,322,7,malware,smokeloader
3970560506546069061,10.127.0.160,52.152.110.14,443,tcp,-,90232,0,0,1560,30,1560,30,malware,smokeloader
8370149618487946232,10.127.0.160,109.206.243.140,80,tcp,http,85098,177580,223,22996,233,200576,456,malware,smokeloader
6544971333473671840,10.127.0.160,173.223.113.164,443,tcp,-,18953,0,0,322,7,322,7,malware,smokeloader
-8490495381726617454,10.127.0.160,173.223.113.131,80,tcp,-,18953,0,0,322,7,322,7,malware,smokeloader
-4856357539578963007,10.127.0.160,204.79.197.203,80,tcp,-,18953,0,0,322,7,322,7,malware,smokeloader
5230239876274659879,10.127.0.167,8.238.7.254,80,tcp,-,0,80,2,92,2,172,4,malware,smokeloader
5634329940448841633,10.127.0.98,8.8.8.8,53,udp,dns,18529,13523,96,7246,101,20769,197,normal,-
-2353892441626417985,10.127.0.98,185.246.221.154,80,tcp,http,3485,402,5,837,6,1239,11,malware,smokeloader
-5589369622762136761,10.127.0.98,52.152.110.14,443,tcp,-,344743,0,0,6136,118,6136,118,malware,smokeloader
8586964543081946713,10.127.0.98,84.53.175.11,80,tcp,-,189455,0,0,3220,70,3220,70,malware,smokeloader
570719051209374421,10.127.0.98,173.223.113.164,443,tcp,-,151620,0,0,2576,56,2576,56,malware,smokeloader
1482907685730273262,10.127.0.98,209.197.3.8,80,tcp,-,282627,0,0,4936,103,4936,103,malware,smokeloader
4159581546410781127,10.127.0.98,93.184.220.29,80,tcp,-,169909,0,0,2910,60,2910,60,malware,smokeloader
1456596676861373319,10.127.0.98,204.79.197.203,80,tcp,-,189584,0,0,3220,70,3220,70,malware,smokeloader
-7956609723465822419,10.127.0.98,173.223.113.131,80,tcp,-,94807,0,0,1610,35,1610,35,malware,smokeloader
828628126230712417,10.127.0.119,8.8.8.8,53,udp,dns,18103,23068,174,12038,174,35106,348,normal,-
2498294900991345143,10.127.0.119,20.190.159.73,443,tcp,-,15031,0,0,260,5,260,5,malware,smokeloader
-7466102659825371299,10.127.0.119,172.67.181.144,80,tcp,http,110000,2079692,1609,51745,840,2131437,2449,malware,smokeloader
3695151630054133159,10.127.0.119,211.53.230.67,80,tcp,http,25322,2702426,1963,68907,1437,2771333,3400,malware,smokeloader
69368368020655876,10.127.0.119,45.9.74.80,80,tcp,-,15044,0,0,260,5,260,5,malware,smokeloader
-7743716821316196342,10.127.0.119,162.0.217.254,443,tcp,http,179704,49248,68,6418,91,55666,159,malware,smokeloader
521353789819726472,10.127.0.119,20.54.89.15,443,tcp,-,75146,0,0,1300,25,1300,25,malware,smokeloader
-4918234889666714271,10.127.0.119,211.40.39.251,80,tcp,http,4009,11430,16,1059,18,12489,34,malware,smokeloader
8294946864489600656,10.127.0.119,149.154.167.99,443,tcp,http,30421,58177,60,4786,72,62963,132,malware,smokeloader
6701978860262869582,10.127.0.119,95.216.179.190,80,tcp,http,28734,8302565,6077,764678,6311,9067243,12388,malware,smokeloader
-3931044904095546242,10.127.0.119,79.137.206.226,80,tcp,http,5312,208448,160,8279,157,216727,317,malware,smokeloader
-1940055902946200118,10.127.0.119,172.67.141.51,443,tcp,http,2086,663164,541,14063,286,677227,827,malware,smokeloader
-4133942943119470697,10.127.0.119,161.97.179.222,443,tcp,http,65300,215315,164,7377,115,222692,279,malware,smokeloader
-7773954456611375089,10.127.0.119,89.190.157.61,80,tcp,http,5599,280856,205,5107,107,285963,312,malware,smokeloader
7165732022065939996,10.127.0.119,173.223.113.164,443,tcp,-,133276,0,0,2254,49,2254,49,malware,smokeloader
-3077165436719946302,10.127.0.119,173.223.113.131,80,tcp,-,133045,0,0,2254,49,2254,49,malware,smokeloader
-3480355149049808427,10.127.0.119,131.253.33.203,80,tcp,-,95139,0,0,1610,35,1610,35,malware,smokeloader
7338949952093959179,10.127.0.119,93.184.221.240,80,tcp,-,239083,0,0,4062,87,4062,87,malware,smokeloader
1006875077051937857,10.127.0.119,109.206.243.140,80,tcp,http,14492,219386,510,73804,606,293190,1116,malware,smokeloader
8122113086944296129,10.127.0.119,195.158.3.162,80,tcp,http,2116,20910,22,1292,24,22202,46,malware,smokeloader
-826457628986432075,10.127.0.119,51.91.79.17,443,tcp,tls,299,7236,9,813,8,8049,17,malware,smokeloader
-638620857313816509,10.127.0.119,211.171.233.129,80,tcp,http,19033,5903,44,7881,56,13784,100,malware,smokeloader
2822212063630694942,10.127.0.119,45.159.189.105,80,tcp,http,393,3399,12,1527,18,4926,30,malware,smokeloader
-1928744583625901899,10.127.0.119,190.211.254.211,80,tcp,http,393,324262,343,5590,118,329852,461,malware,smokeloader
-5129882015281290429,10.127.0.182,95.101.78.82,80,tcp,-,56833,0,0,966,21,966,21,malware,smokeloader
-6759991315633445826,10.127.0.182,178.79.208.1,80,tcp,-,113710,0,0,1932,42,1932,42,malware,smokeloader
-5516956069651063888,10.127.0.55,8.8.8.8,53,udp,dns,6549,6036,42,2989,42,9025,84,normal,-
6243643145661733617,10.127.0.55,185.246.221.154,80,tcp,http,9198,362,4,691,6,1053,10,malware,smokeloader
7436663638655332036,10.127.0.55,52.152.110.14,443,tcp,-,418916,0,0,7592,146,7592,146,malware,smokeloader
-926388663555603073,10.127.0.55,20.44.10.122,443,tcp,-,94790,0,0,1610,35,1610,35,malware,smokeloader
69620868537068080,10.127.0.55,8.238.179.126,80,tcp,-,189530,0,0,3220,70,3220,70,malware,smokeloader
7866177114819020516,10.127.0.55,173.223.113.164,443,tcp,-,94776,0,0,1610,35,1610,35,malware,smokeloader
-6405103424812527642,10.127.0.55,173.223.113.131,80,tcp,-,94765,0,0,1610,35,1610,35,malware,smokeloader
-2779910056296727907,10.127.0.55,131.253.33.203,80,tcp,-,94761,0,0,1610,35,1610,35,malware,smokeloader
474236222783179728,10.127.0.199,8.8.8.8,53,udp,dns,286,646,6,381,6,1027,12,normal,-
-3133585128036224565,10.127.0.199,104.237.62.211,443,tcp,http,4099,6919,11,1014,10,7933,21,malware,agenttesla
2255665076256117904,10.127.0.184,8.8.8.8,53,udp,dns,13538,19259,135,10041,140,29300,275,normal,-
-1352156274563286389,10.127.0.184,104.237.62.211,443,tcp,http,101469,7007,13,1011,11,8018,24,malware,agenttesla
1105570912759723167,10.127.0.184,20.54.89.15,443,tcp,-,105202,0,0,1820,35,1820,35,malware,agenttesla
-5386248911198347956,10.127.0.184,209.197.3.8,80,tcp,-,151622,0,0,2576,56,2576,56,malware,agenttesla
5805757343619691536,10.127.0.105,8.8.8.8,53,udp,dns,34377,14682,104,8873,124,23555,228,normal,-
7928511190608109945,10.127.0.105,104.237.62.211,443,tcp,http,100878,6927,11,1011,11,7938,22,malware,agenttesla
742146454380224324,10.127.0.105,173.223.113.164,443,tcp,-,151621,0,0,2576,56,2576,56,malware,agenttesla
1899963780669032817,10.127.0.105,173.223.113.131,80,tcp,-,189526,0,0,3220,70,3220,70,malware,agenttesla
-6450633623385908146,10.127.0.105,20.189.173.15,443,tcp,-,37906,0,0,644,14,644,14,malware,agenttesla
-1760948585047692262,10.127.0.181,8.8.8.8,53,udp,dns,3700,12412,86,6127,86,18539,172,normal,-
361805261940726147,10.127.0.181,104.237.62.211,443,tcp,http,101113,6927,11,1011,11,7938,22,malware,agenttesla
-1094535375445930083,10.127.0.181,52.152.110.14,443,tcp,-,314841,0,0,5616,108,5616,108,malware,agenttesla
1300853824048561663,10.127.0.181,40.79.189.59,443,tcp,-,94029,0,0,966,21,966,21,malware,agenttesla
3292237213464641456,10.127.0.181,95.101.78.106,80,tcp,-,56849,0,0,966,21,966,21,malware,agenttesla
-6509561975083759773,10.127.0.181,173.223.113.131,80,tcp,-,152152,0,0,2576,56,2576,56,malware,agenttesla
7135635003311561590,10.127.0.181,131.253.33.203,80,tcp,-,113730,0,0,1932,42,1932,42,malware,agenttesla
-6824559474287159474,10.127.0.181,173.223.113.164,443,tcp,-,114128,0,0,1932,42,1932,42,malware,agenttesla
-3346986002893943476,10.127.0.53,209.197.3.8,80,tcp,-,143793,0,0,2452,52,2452,52,malware,agenttesla
3558382487709200464,10.127.0.53,20.189.173.10,443,tcp,-,57233,0,0,966,21,966,21,malware,agenttesla
8027417773311851372,10.127.0.53,204.79.197.203,80,tcp,-,56862,0,0,966,21,966,21,malware,agenttesla
8854711509797818054,10.127.0.162,8.8.8.8,53,udp,dns,18749,24825,182,13137,188,37962,370,normal,-
-5071987140141256210,10.127.0.162,20.54.89.15,443,tcp,-,60128,0,0,1040,20,1040,20,malware,agenttesla
8255498896352313403,10.127.0.162,64.185.227.155,443,tcp,http,100559,6927,11,1011,11,7938,22,malware,agenttesla
4633707677881629787,10.127.0.162,162.19.139.184,2222,tcp,-,0,390,1,46,1,436,2,malware,agenttesla
-2476285147114235747,10.127.0.162,67.24.35.254,80,tcp,-,105945,0,0,1808,38,1808,38,malware,agenttesla
-7653286051060874111,10.127.0.162,173.223.113.164,443,tcp,-,152406,0,0,2576,56,2576,56,malware,agenttesla
2804020596083245036,10.127.0.162,173.223.113.131,80,tcp,-,75811,0,0,1288,28,1288,28,malware,agenttesla
3790486532580410786,10.127.0.162,204.79.197.203,80,tcp,-,75811,0,0,1288,28,1288,28,malware,agenttesla
-7308513631280054781,10.127.0.121,8.8.8.8,53,udp,dns,5143,12611,95,6718,95,19329,190,normal,-
-1161150659957871413,10.127.0.121,195.178.106.125,443,tcp,http,853,236912,173,4739,94,241651,267,malware,agenttesla
567626958654587106,10.127.0.121,20.42.65.90,443,tcp,-,37906,0,0,644,14,644,14,malware,agenttesla
-7938319941353211273,10.127.0.168,209.197.3.8,80,tcp,-,143967,0,0,2452,52,2452,52,malware,agenttesla
-8357925939978566029,10.127.0.168,93.184.220.29,80,tcp,-,56834,0,0,966,21,966,21,malware,agenttesla
4101951429085622715,10.127.0.168,8.8.8.8,53,udp,dns,11236,14855,104,7787,108,22642,212,normal,-
6098186121348230213,10.127.0.168,13.69.109.130,443,tcp,-,56906,0,0,966,21,966,21,malware,agenttesla
6207685968869942754,10.127.0.168,40.126.31.69,443,tcp,-,15014,0,0,260,5,260,5,malware,agenttesla
8122555071132549746,10.127.0.168,91.235.128.141,587,tcp,-,15029,0,0,260,5,260,5,malware,agenttesla
-961659460153844497,10.127.0.168,173.223.113.164,443,tcp,-,151834,0,0,2576,56,2576,56,malware,agenttesla
786381731989646661,10.127.0.63,8.8.8.8,53,udp,dns,789,8682,59,4248,59,12930,118,normal,-
-272780851999847292,10.127.0.63,93.184.220.29,80,tcp,-,189547,0,0,3220,70,3220,70,malware,agenttesla
7192854435260364289,10.127.0.63,209.197.3.8,80,tcp,-,94784,0,0,1610,35,1610,35,malware,agenttesla
7123485627824874240,10.127.0.63,173.223.113.164,443,tcp,-,94817,0,0,1610,35,1610,35,malware,agenttesla
-865951798740558229,10.127.0.63,173.223.113.131,80,tcp,-,94764,0,0,1610,35,1610,35,malware,agenttesla
-1269141511070420354,10.127.0.63,131.253.33.203,80,tcp,-,94761,0,0,1610,35,1610,35,malware,agenttesla
2788143130728649316,10.127.0.163,8.253.208.113,80,tcp,-,121022,0,0,2068,43,2068,43,malware,agenttesla
6284369833723266919,10.127.0.163,20.54.89.15,443,tcp,-,120241,0,0,2080,40,2080,40,malware,agenttesla
7606561482563316187,10.127.0.163,52.168.112.67,443,tcp,-,75949,0,0,1288,28,1288,28,malware,agenttesla
-6537088945110126339,10.127.0.107,8.238.110.126,80,tcp,-,226203,0,0,3680,80,3680,80,malware,agenttesla
-6121702953891070352,10.127.0.107,8.8.8.8,53,udp,dns,6450,21836,163,11518,164,33354,327,normal,-
8787112425626646863,10.127.0.107,20.190.160.20,443,tcp,-,15013,0,0,260,5,260,5,malware,agenttesla
-6630701162497209839,10.127.0.107,107.172.4.169,80,tcp,http,26838,1899257,1359,32275,700,1931532,2059,malware,agenttesla
6831916754415325572,10.127.0.107,52.152.110.14,443,tcp,-,780274,0,0,13832,266,13832,266,malware,agenttesla
-1917084258361443472,10.127.0.107,20.50.201.195,443,tcp,-,75825,0,0,1288,28,1288,28,malware,agenttesla
7261430230579014052,10.127.0.107,173.223.113.164,443,tcp,-,189730,0,0,3220,70,3220,70,malware,agenttesla
-7009850309052534106,10.127.0.107,173.223.113.131,80,tcp,-,189981,0,0,3220,70,3220,70,malware,agenttesla
-9115232138344557073,10.127.0.107,131.253.33.203,80,tcp,-,189976,0,0,3220,70,3220,70,malware,agenttesla
707983577839701312,10.127.0.107,93.184.220.29,80,tcp,-,279867,80,2,4872,102,4952,104,malware,agenttesla
-5749908956689363719,10.127.0.12,8.8.8.8,53,udp,dns,54,302,2,123,2,425,4,normal,-
-5007866284896118473,10.127.0.12,104.237.62.211,443,tcp,http,102403,6897,11,1060,11,7957,22,malware,agenttesla
-8454151305215930495,10.127.0.80,8.8.8.8,53,udp,dns,6389,18086,152,10426,152,28512,304,normal,-
-8476294808991426385,10.127.0.80,104.237.62.211,443,tcp,http,124045,14308,25,2120,22,16428,47,malware,agenttesla
-3680359337420602290,10.127.0.111,8.8.8.8,53,udp,dns,1480,7896,54,3829,54,11725,108,normal,-
-7288180688240006583,10.127.0.111,104.237.62.211,443,tcp,http,62429,6937,12,1014,10,7951,22,malware,agenttesla
6569598872046743237,10.127.0.189,209.197.3.8,80,tcp,-,522296,0,0,8904,189,8904,189,malware,agenttesla
-4186737853836623930,10.127.0.189,8.8.8.8,53,udp,dns,69267,29289,205,15071,210,44360,415,normal,-
6978301727590010150,10.127.0.189,52.152.108.96,443,tcp,-,105154,0,0,1820,35,1820,35,malware,agenttesla
5155234927480148481,10.127.0.189,52.168.117.170,443,tcp,-,132646,0,0,2254,49,2254,49,malware,agenttesla
4798037947649092346,10.127.0.189,173.223.113.164,443,tcp,-,227446,0,0,3864,84,3864,84,malware,agenttesla
8973501481727095804,10.127.0.189,173.223.113.131,80,tcp,-,227434,0,0,3864,84,3864,84,malware,agenttesla
368926185541835095,10.127.0.189,204.79.197.203,80,tcp,-,170574,0,0,2898,63,2898,63,malware,agenttesla
-1692797246437046896,10.127.0.101,40.77.2.164,443,tcp,-,111859,0,0,1656,36,1656,36,malware,agenttesla
98719859240001570,10.127.0.101,52.152.110.14,443,tcp,-,120238,0,0,2080,40,2080,40,malware,agenttesla
-1854299657275354898,10.127.0.101,8.8.8.8,53,udp,dns,48404,20623,142,10645,147,31268,289,normal,-
2423133389547715946,10.127.0.101,117.18.232.240,80,tcp,-,620671,0,0,4384,94,4384,94,malware,agenttesla
2058767392696690587,10.127.0.101,117.18.237.29,80,tcp,-,45234,0,0,780,15,780,15,malware,agenttesla
5565127273606307937,10.127.0.101,20.253.213.245,80,tcp,-,0,0,0,276,6,276,6,malware,agenttesla
7358987834469630464,10.127.0.101,91.235.128.141,587,tcp,-,100284,7158,27,8202,27,15360,54,malware,agenttesla
2673130686167604349,10.127.0.101,173.223.113.164,443,tcp,-,151635,0,0,2576,56,2576,56,malware,agenttesla
8732079950327355368,10.127.0.101,173.223.113.131,80,tcp,-,151623,0,0,2576,56,2576,56,malware,agenttesla
8328890237997493243,10.127.0.101,131.253.33.203,80,tcp,-,113715,0,0,1932,42,1932,42,malware,agenttesla
5051445649553628806,10.127.0.112,8.8.8.8,53,udp,dns,837,4039,27,1987,27,6026,54,normal,-
-4953754010118355718,10.127.0.112,195.178.120.24,80,tcp,http,204,230112,166,4121,88,234233,254,malware,agenttesla
2562712920486495261,10.127.0.112,13.69.239.73,443,tcp,-,37904,0,0,644,14,644,14,malware,agenttesla
-1446749302926426756,10.127.0.112,8.238.178.254,80,tcp,-,113716,0,0,1932,42,1932,42,malware,agenttesla
-12165239685838406,10.127.0.112,173.223.113.164,443,tcp,-,37905,0,0,644,14,644,14,malware,agenttesla
5972971846784433384,10.127.0.112,173.223.113.131,80,tcp,-,37905,0,0,644,14,644,14,malware,agenttesla
8217454040105059956,10.127.0.112,131.253.33.203,80,tcp,-,37905,0,0,644,14,644,14,malware,agenttesla
2734912418303190245,10.127.0.112,93.184.221.240,80,tcp,-,52946,0,0,904,19,904,19,malware,agenttesla
5899274596455630355,10.127.0.27,8.8.8.8,53,udp,dns,28,134,1,70,1,204,2,normal,-
3546702065606052981,10.127.0.27,208.91.198.143,587,tcp,-,4172,7570,18,1708,17,9278,35,malware,agenttesla
-2404780293217719387,10.127.0.165,52.152.108.96,443,tcp,-,60085,0,0,1040,20,1040,20,malware,agenttesla
-915212059085163778,10.127.0.165,20.50.73.9,443,tcp,-,94765,0,0,1610,35,1610,35,malware,agenttesla
-4585044073158637191,10.127.0.165,173.223.113.164,443,tcp,-,132667,0,0,2254,49,2254,49,malware,agenttesla
-9157801944677651400,10.127.0.165,173.223.113.131,80,tcp,-,94782,0,0,1610,35,1610,35,malware,agenttesla
-8171336008180485650,10.127.0.165,204.79.197.203,80,tcp,-,94762,0,0,1610,35,1610,35,malware,agenttesla
-2546858830507099773,10.127.0.165,91.235.128.141,587,tcp,-,1433,7055,27,8027,24,15082,51,malware,agenttesla
-1589035106593421785,10.127.0.25,8.8.8.8,53,udp,dns,130,205,2,122,2,327,4,normal,-
-9151427360569008709,10.127.0.25,104.237.62.211,443,tcp,http,61245,7134,12,1060,11,8194,23,malware,agenttesla
4187995211314921819,10.127.0.53,64.185.227.155,443,tcp,-,7005,0,0,208,4,208,4,malware,agenttesla
2324352446357342425,10.127.0.168,172.245.135.141,80,tcp,http,6607,863246,619,17277,359,880523,978,malware,agenttesla
494130078266218422,10.127.0.168,104.237.62.211,443,tcp,http,1549,6788,10,968,9,7756,19,malware,agenttesla
-6267585029264287699,10.127.0.176,8.8.8.8,53,udp,dns,23050,24010,180,13372,191,37382,371,normal,-
4027171965823826650,10.127.0.176,20.189.173.6,443,tcp,-,37905,0,0,644,14,644,14,malware,agenttesla
-2148574736472510444,10.127.0.176,52.152.108.96,443,tcp,-,30024,0,0,520,10,520,10,malware,agenttesla
7389554682104866775,10.127.0.176,173.231.16.76,443,tcp,http,121457,13894,23,1884,19,15778,42,malware,agenttesla
138887674006429929,10.127.0.176,209.197.3.8,80,tcp,-,76410,0,0,1288,28,1288,28,malware,agenttesla
-512663625839233106,10.127.0.117,8.8.8.8,53,udp,dns,1546,7206,51,3669,51,10875,102,normal,-
2901378340718151035,10.127.0.117,93.184.221.240,80,tcp,-,170581,0,0,2898,63,2898,63,malware,agenttesla
3606346666952544149,10.127.0.117,52.152.108.96,443,tcp,-,15016,0,0,260,5,260,5,malware,agenttesla
4766345653341669270,10.127.0.117,91.235.128.141,587,tcp,-,100294,7238,29,8202,27,15440,56,malware,agenttesla
190533568946691911,10.127.0.117,40.79.141.154,443,tcp,-,18952,0,0,322,7,322,7,malware,agenttesla
2728160410690131852,10.127.0.117,173.223.113.164,443,tcp,-,75809,0,0,1288,28,1288,28,malware,agenttesla
6139437769199394174,10.127.0.117,173.223.113.131,80,tcp,-,18953,0,0,322,7,322,7,malware,agenttesla
1395328507888737222,10.127.0.117,204.79.197.203,80,tcp,-,18953,0,0,322,7,322,7,malware,agenttesla
7658314657961484081,10.127.0.119,93.184.220.29,80,tcp,-,52926,40,1,950,20,990,21,malware,agenttesla
-2628758421286230151,10.127.0.119,173.231.16.76,443,tcp,http,100729,6927,11,1011,11,7938,22,malware,agenttesla
2936764531792124359,10.127.0.119,13.89.179.9,443,tcp,-,37905,0,0,644,14,644,14,malware,agenttesla
3655832005172383515,10.127.0.106,173.231.16.76,443,tcp,tls,5287,6700,11,859,11,7559,22,malware,agenttesla
5487893453287001145,10.127.0.175,8.8.8.8,53,udp,dns,29799,24570,171,13318,186,37888,357,normal,-
-4148475307471480276,10.127.0.175,173.223.113.131,80,tcp,http,303585,9102,18,1816,28,10918,46,normal,-
-3618138996773108622,10.127.0.175,20.189.173.9,443,tcp,-,56857,0,0,966,21,966,21,malware,agenttesla
-6220095668198679591,10.127.0.175,20.54.89.15,443,tcp,-,45057,0,0,780,15,780,15,malware,agenttesla
-1655959538144900713,10.127.0.175,93.184.221.240,80,tcp,-,113715,0,0,1932,42,1932,42,malware,agenttesla
1880072102467596852,10.127.0.175,104.237.62.211,443,tcp,http,102868,13814,21,1982,21,15796,42,malware,agenttesla
2726113365850115338,10.127.0.111,209.197.3.8,80,tcp,-,154860,0,0,2650,55,2650,55,malware,agenttesla
3149327194310169374,10.127.0.111,93.184.220.29,80,tcp,-,219593,0,0,3740,80,3740,80,malware,agenttesla
-8743970226660069502,10.127.0.111,173.223.113.164,443,tcp,-,75809,0,0,1288,28,1288,28,malware,agenttesla
5130015975530467905,10.127.0.111,173.223.113.131,80,tcp,-,56859,0,0,966,21,966,21,malware,agenttesla
-6673888521874089011,10.127.0.111,131.253.33.203,80,tcp,-,56860,0,0,966,21,966,21,malware,agenttesla
-8010441411273312522,10.127.0.113,23.44.232.24,443,tcp,tls,1,104,2,92,2,196,4,malware,agenttesla
8494765450863585288,10.127.0.113,64.185.227.155,443,tcp,http,100515,6927,11,1011,11,7938,22,malware,agenttesla
1475161334701621510,10.127.0.113,13.248.151.210,443,tcp,tls,0,76,1,46,1,122,2,malware,agenttesla
-3380180739513763767,10.127.0.113,76.223.31.44,443,tcp,tls,1,80,1,46,1,126,2,malware,agenttesla
818310347792868446,10.127.0.113,23.32.238.98,443,tcp,tls,0,104,2,92,2,196,4,malware,agenttesla
-5505319435480092811,10.127.0.113,76.223.111.18,443,tcp,tls,0,157,2,92,2,249,4,malware,agenttesla
-3004172234393831398,10.127.0.113,23.32.238.136,443,tcp,tls,5,728,14,644,14,1372,28,malware,agenttesla
-1046027874451514671,10.127.0.113,193.0.160.131,443,tcp,-,0,40,1,0,0,40,1,malware,agenttesla
-7994148534565739408,10.127.0.113,151.101.1.108,443,tcp,tls,1,111,2,92,2,203,4,malware,agenttesla
8081530620602092381,10.127.0.113,130.211.23.194,443,tcp,tls,0,113,1,46,1,159,2,malware,agenttesla
-3755411424220804751,10.127.0.113,34.107.148.139,443,tcp,tls,0,113,1,46,1,159,2,malware,agenttesla
-4441102195449308352,10.127.0.113,35.241.34.106,443,tcp,tls,1,113,1,46,1,159,2,malware,agenttesla
-310032563042888286,10.127.0.113,34.149.40.38,443,tcp,tls,1,113,1,46,1,159,2,malware,agenttesla
-1871613327008703540,10.127.0.113,34.111.113.62,443,tcp,tls,0,113,1,46,1,159,2,malware,agenttesla
-143863860380980545,10.127.0.113,35.186.193.173,443,tcp,tls,0,113,1,46,1,159,2,malware,agenttesla
-1702457801041879291,10.127.0.113,35.190.60.146,443,tcp,tls,1,226,2,92,2,318,4,malware,agenttesla
5104870226097679517,10.127.0.113,34.102.253.54,443,tcp,tls,0,113,1,46,1,159,2,malware,agenttesla
6008662497024424602,10.127.0.113,35.244.159.8,443,tcp,tls,0,113,1,46,1,159,2,malware,agenttesla
1489603475658524602,10.127.0.113,151.101.2.49,443,tcp,tls,1,209,3,138,3,347,6,malware,agenttesla
6319098219010848652,10.127.0.113,107.178.254.65,443,tcp,tls,1,113,1,46,1,159,2,malware,agenttesla
-9075528226983876337,10.127.0.113,34.98.67.3,443,tcp,tls,0,113,1,46,1,159,2,malware,agenttesla
3727759568341843832,10.127.0.113,35.213.93.179,443,tcp,tls,0,113,1,46,1,159,2,malware,agenttesla
6290481414175829429,10.127.0.113,104.16.109.79,443,tcp,tls,3,549,9,414,9,963,18,malware,agenttesla
-8185834940296683785,10.127.0.113,35.208.249.213,443,tcp,tls,0,113,1,46,1,159,2,malware,agenttesla
-559051418526448155,10.127.0.190,8.8.8.8,53,udp,dns,18454,10099,69,5694,79,15793,148,normal,-
4669417265757705035,10.127.0.190,20.42.65.90,443,tcp,-,37902,0,0,644,14,644,14,malware,agenttesla
-8270885312382997375,10.127.0.190,52.152.110.14,443,tcp,-,180299,0,0,3120,60,3120,60,malware,agenttesla
-9069756714816248930,10.127.0.190,8.247.210.254,80,tcp,-,76078,0,0,1288,28,1288,28,malware,agenttesla
5778052477308779424,10.127.0.190,173.223.113.164,443,tcp,-,113772,0,0,1932,42,1932,42,malware,agenttesla
4222940813578960180,10.127.0.190,173.223.113.131,80,tcp,-,37921,0,0,644,14,644,14,malware,agenttesla
-40714933625505702,10.127.0.190,131.253.33.203,80,tcp,-,37920,0,0,644,14,644,14,malware,agenttesla
592408664363801747,10.127.0.219,172.245.191.24,80,tcp,http,238,635,2,508,4,1143,6,malware,agenttesla
-735090982443942607,10.127.0.50,52.137.108.250,443,tcp,-,37269,0,0,552,12,552,12,malware,agenttesla
-5462274964747142615,10.127.0.50,209.197.3.8,80,tcp,-,150886,0,0,2588,53,2588,53,malware,agenttesla
6577996405691691373,10.127.0.50,8.8.8.8,53,udp,dns,1033,6186,42,3022,42,9208,84,normal,-
-4909487726342994436,10.127.0.50,52.182.141.63,443,tcp,-,37920,0,0,644,14,644,14,malware,agenttesla
1514385516452224161,10.127.0.50,173.223.113.164,443,tcp,-,56855,0,0,966,21,966,21,malware,agenttesla
-4178544205248901732,10.127.0.173,20.50.80.209,443,tcp,-,56965,0,0,966,21,966,21,malware,agenttesla
-1662567814118941421,10.127.0.173,93.184.221.240,80,tcp,-,56859,0,0,966,21,966,21,malware,agenttesla
8621520902997158543,10.127.0.173,173.223.113.131,80,tcp,-,56857,0,0,966,21,966,21,malware,agenttesla
6281661488844298324,10.127.0.173,87.248.202.1,80,tcp,-,56855,0,0,966,21,966,21,malware,agenttesla
-5467740088762295275,10.127.0.173,91.235.128.141,587,tcp,-,930,6979,26,5464,26,12443,52,malware,agenttesla
6800172897486773281,10.127.0.177,52.109.13.63,443,tcp,-,0,40,1,0,0,40,1,malware,agenttesla
-4613984479796226682,10.127.0.177,20.189.173.6,443,tcp,-,57160,0,0,966,21,966,21,malware,agenttesla
-5085589216567205143,10.127.0.177,209.197.3.8,80,tcp,-,177787,0,0,3106,67,3106,67,malware,agenttesla
-2672882327117813454,10.127.0.170,209.197.3.8,80,tcp,-,15027,0,0,260,5,260,5,malware,agenttesla
-2189663293473868195,10.127.0.170,190.171.170.94,443,tcp,http,1491380,1282105,1589,91319,1201,1373424,2790,malware,agenttesla
-2742802233519896814,10.127.0.170,52.152.110.14,443,tcp,-,90130,0,0,1560,30,1560,30,malware,agenttesla
-3444964085050648171,10.127.0.114,87.248.202.1,80,tcp,-,71892,0,0,1226,26,1226,26,malware,agenttesla
-4628691265869220942,10.127.0.114,8.8.8.8,53,udp,dns,1304,6714,48,3393,48,10107,96,normal,-
1708412629966006637,10.127.0.114,173.223.113.164,443,tcp,-,75809,0,0,1288,28,1288,28,malware,agenttesla
-2420558761724822075,10.127.0.114,173.223.113.131,80,tcp,-,75812,0,0,1288,28,1288,28,malware,agenttesla
-5294558860102260082,10.127.0.114,204.79.197.203,80,tcp,-,56859,0,0,966,21,966,21,malware,agenttesla
-6335059440294993433,10.127.0.176,88.221.25.155,80,tcp,-,37892,0,0,644,14,644,14,malware,agenttesla
562101502466483965,10.127.0.176,93.184.220.29,80,tcp,-,75840,0,0,1288,28,1288,28,malware,agenttesla
-5527644328273900425,10.127.0.176,87.248.202.1,80,tcp,-,75887,0,0,1288,28,1288,28,malware,agenttesla
69518866570939880,10.127.0.176,173.223.113.164,443,tcp,-,37905,0,0,644,14,644,14,malware,agenttesla
2542790283686782496,10.127.0.176,173.223.113.131,80,tcp,-,37905,0,0,644,14,644,14,malware,agenttesla
3529256220183948246,10.127.0.176,204.79.197.203,80,tcp,-,37905,0,0,644,14,644,14,malware,agenttesla
-1446975409765237302,10.127.0.119,104.237.62.211,443,tcp,http,106411,14151,26,2361,24,16512,50,malware,agenttesla
379196142943010072,10.127.0.32,8.8.8.8,53,udp,dns,35,126,1,59,1,185,2,normal,-
8615876057026486067,10.127.0.32,104.237.62.211,443,tcp,http,102653,7134,12,1106,12,8240,24,malware,agenttesla
7913444200697199123,10.127.0.28,107.172.4.169,80,tcp,-,36584,1899257,1359,33485,726,1932742,2085,malware,agenttesla
-8271774783608947967,10.127.0.31,8.8.8.8,53,udp,dns,1798,1443,15,961,15,2404,30,normal,-
2612577036125016725,10.127.0.31,104.237.62.211,443,tcp,tls,4778,6700,11,807,10,7507,21,malware,agenttesla
7868061318205646095,10.127.0.169,8.8.8.8,53,udp,dns,1013,3379,24,1687,24,5066,48,normal,-
4260239967386241802,10.127.0.169,104.237.62.211,443,tcp,-,2153,124,3,190,4,314,7,malware,agenttesla
-7558734233769418399,10.127.0.175,13.69.239.73,443,tcp,-,95221,0,0,1610,35,1610,35,malware,agenttesla
-1278964026315233712,10.127.0.175,8.238.20.126,80,tcp,-,287730,0,0,4830,105,4830,105,malware,agenttesla
424282564047533933,10.127.0.175,173.223.113.164,443,tcp,-,114508,0,0,1932,42,1932,42,malware,agenttesla
6362236341141670356,10.127.0.103,20.190.159.75,443,tcp,-,15044,0,0,260,5,260,5,malware,agenttesla
8846732340580117493,10.127.0.103,8.8.8.8,53,udp,dns,2184,8507,67,4616,67,13123,134,normal,-
2087982152129694971,10.127.0.103,64.185.227.155,443,tcp,-,7008,0,0,208,4,208,4,malware,agenttesla
3956339381368669464,10.127.0.103,93.184.221.240,80,tcp,-,75801,0,0,1288,28,1288,28,malware,agenttesla
8385422669266513499,10.127.0.103,13.69.239.74,443,tcp,-,37905,0,0,644,14,644,14,malware,agenttesla
3783121451340650281,10.127.0.103,173.223.113.164,443,tcp,-,76243,0,0,1288,28,1288,28,malware,agenttesla
5853203156126630772,10.127.0.103,131.253.33.203,80,tcp,-,37905,0,0,644,14,644,14,malware,agenttesla
-8033543289773665224,10.127.0.165,208.91.198.143,587,tcp,-,2470,7845,18,1317,17,9162,35,malware,agenttesla
-3380907614295068448,10.127.0.62,104.237.62.211,443,tcp,http,100746,6927,11,965,10,7892,21,malware,agenttesla
1361210309517248113,10.127.0.170,104.237.62.211,443,tcp,http,102013,6967,12,1441,13,8408,25,malware,agenttesla
7037727519746050059,10.127.0.163,13.89.179.10,443,tcp,-,75808,0,0,1288,28,1288,28,malware,agenttesla
-4580591902143310854,10.127.0.163,93.184.221.240,80,tcp,-,243037,0,0,4124,89,4124,89,malware,agenttesla
733543010341522248,10.127.0.20,8.8.8.8,53,udp,dns,26,126,1,59,1,185,2,normal,-
-470383504954966491,10.127.0.20,173.231.16.76,443,tcp,http,102513,6897,11,1060,11,7957,22,malware,agenttesla
3664497040186714561,10.127.0.188,209.197.3.8,80,tcp,-,367354,0,0,6254,134,6254,134,malware,agenttesla
-488515630863549238,10.127.0.188,8.8.8.8,53,udp,dns,12680,21063,147,10715,152,31778,299,normal,-
-6506935825912587151,10.127.0.188,20.42.72.131,443,tcp,-,75805,0,0,1288,28,1288,28,malware,agenttesla
-7770220123146466774,10.127.0.188,52.152.108.96,443,tcp,-,60079,0,0,1040,20,1040,20,malware,agenttesla
2752308405665815720,10.127.0.188,173.223.113.164,443,tcp,-,189537,0,0,3220,70,3220,70,malware,agenttesla
-5775020369009381120,10.127.0.188,173.223.113.131,80,tcp,-,75805,0,0,1288,28,1288,28,malware,agenttesla
-9138418455124864909,10.127.0.188,204.79.197.203,80,tcp,-,132661,0,0,2254,49,2254,49,malware,agenttesla
-1443186889553855428,10.127.0.69,93.184.221.240,80,tcp,-,75788,0,0,1288,28,1288,28,malware,agenttesla
7081377277073219593,10.127.0.69,8.8.8.8,53,udp,dns,1738,12679,92,6493,92,19172,184,normal,-
-185816242292910820,10.127.0.69,93.184.220.29,80,tcp,-,160251,0,0,2712,57,2712,57,malware,agenttesla
-4626611844412461143,10.127.0.69,20.54.89.15,443,tcp,-,30029,0,0,520,10,520,10,malware,agenttesla
6367630410446401920,10.127.0.69,173.223.113.164,443,tcp,-,114287,0,0,1932,42,1932,42,malware,agenttesla
1794872538927387711,10.127.0.69,173.223.113.131,80,tcp,-,114324,0,0,1932,42,1932,42,malware,agenttesla
-1568525547188096078,10.127.0.69,204.79.197.203,80,tcp,-,37904,0,0,644,14,644,14,malware,agenttesla
7823419948866464839,10.127.0.69,104.237.62.211,443,tcp,http,946,6816,9,919,9,7735,18,malware,agenttesla
-775575814055685463,10.127.0.60,93.184.220.29,80,tcp,-,219463,0,0,3740,80,3740,80,malware,agenttesla
261443266158312600,10.127.0.60,104.237.62.211,443,tcp,http,170656,20821,34,3097,34,23918,68,malware,agenttesla
-5152656338484785319,10.127.0.60,41.216.182.172,587,tcp,-,100625,2972,42,9694,50,12666,92,malware,agenttesla
-4321753118169054775,10.127.0.60,20.189.173.5,443,tcp,-,94748,0,0,1610,35,1610,35,malware,agenttesla
3459615622207940232,10.127.0.60,8.238.177.126,80,tcp,-,94768,0,0,1610,35,1610,35,malware,agenttesla
-547351138331572128,10.127.0.98,104.237.62.211,443,tcp,http,60797,6927,11,919,9,7846,20,malware,agenttesla
2742018037629168727,10.127.0.98,77.88.21.158,587,tcp,-,76664,6844,28,5616,25,12460,53,malware,agenttesla
-6115030678146616301,10.127.0.183,8.8.8.8,53,udp,dns,4934,17882,126,9052,127,26934,253,normal,-
-8447036784493183251,10.127.0.183,20.189.173.7,443,tcp,-,18952,0,0,322,7,322,7,malware,agenttesla
-6655559614745414791,10.127.0.183,93.184.221.240,80,tcp,-,37906,0,0,644,14,644,14,malware,agenttesla
7268102506323468103,10.127.0.183,173.223.113.164,443,tcp,-,151762,0,0,2576,56,2576,56,malware,agenttesla
8869706312440462093,10.127.0.183,173.223.113.131,80,tcp,-,56859,0,0,966,21,966,21,malware,agenttesla
-1124524632571826491,10.127.0.183,131.253.33.203,80,tcp,-,18953,0,0,322,7,322,7,malware,agenttesla
5220931505339765079,10.127.0.17,8.8.8.8,53,udp,dns,732,3539,27,1771,27,5310,54,normal,-
1613110154520360786,10.127.0.17,104.237.62.211,443,tcp,http,61899,7028,12,1014,10,8042,22,malware,agenttesla
1175569212076483107,10.127.0.193,8.8.8.8,53,udp,dns,30257,18888,134,10779,149,29667,283,normal,-
6444834738570701815,10.127.0.193,13.69.239.74,443,tcp,-,75801,0,0,1288,28,1288,28,malware,agenttesla
-5697715229555252437,10.127.0.193,173.223.113.164,443,tcp,-,75833,0,0,1288,28,1288,28,malware,agenttesla
-4549959181765630767,10.127.0.193,8.238.178.126,80,tcp,-,90819,0,0,1548,33,1548,33,malware,agenttesla
7446778449364292281,10.127.0.52,93.184.221.240,80,tcp,-,45431,0,0,832,16,832,16,malware,agenttesla
-6109572665133811306,10.127.0.52,8.8.8.8,53,udp,dns,1761,6956,49,3457,49,10413,98,normal,-
-1044802072547680999,10.127.0.52,52.152.110.14,443,tcp,-,317583,0,0,5824,112,5824,112,malware,agenttesla
-2705525667266258587,10.127.0.52,20.189.173.3,443,tcp,-,76782,0,0,1288,28,1288,28,malware,agenttesla
-3055736321382019590,10.127.0.52,87.248.202.1,80,tcp,-,75834,0,0,1288,28,1288,28,malware,agenttesla
7273560519336273098,10.127.0.52,173.223.113.164,443,tcp,-,113733,0,0,1932,42,1932,42,malware,agenttesla
-715876907229159371,10.127.0.52,173.223.113.131,80,tcp,-,113816,0,0,1932,42,1932,42,malware,agenttesla
270589029268006379,10.127.0.52,204.79.197.203,80,tcp,-,113813,0,0,1932,42,1932,42,malware,agenttesla
7212859511374889428,10.127.0.116,209.197.3.8,80,tcp,-,302457,0,0,5164,109,5164,109,malware,agenttesla
2260910160988824192,10.127.0.116,8.8.8.8,53,udp,dns,16405,16910,120,8969,125,25879,245,normal,-
-7274870288924490377,10.127.0.116,173.223.113.164,443,tcp,-,75842,0,0,1288,28,1288,28,malware,agenttesla
-8621468139184928146,10.127.0.116,131.253.33.203,80,tcp,-,75828,0,0,1288,28,1288,28,malware,agenttesla
673476675477454103,10.127.0.102,52.152.110.14,443,tcp,-,420800,0,0,7488,144,7488,144,malware,agenttesla
-5005635031396953923,10.127.0.102,93.184.221.240,80,tcp,-,150956,0,0,2588,53,2588,53,malware,agenttesla
-6549567835021119119,10.127.0.102,8.8.8.8,53,udp,dns,9655,8132,59,4544,64,12676,123,normal,-
8289354887869028204,10.127.0.102,104.237.62.211,443,tcp,http,60749,6927,11,919,9,7846,20,malware,agenttesla
-5165827892917621715,10.127.0.102,77.88.21.158,587,tcp,-,77562,6936,30,5668,26,12604,56,malware,agenttesla
280118696709652545,10.127.0.102,93.184.220.29,80,tcp,-,151623,0,0,2576,56,2576,56,malware,agenttesla
6833565349448965285,10.127.0.102,173.223.113.164,443,tcp,-,94780,0,0,1610,35,1610,35,malware,agenttesla
5278453685719146041,10.127.0.102,173.223.113.131,80,tcp,-,94779,0,0,1610,35,1610,35,malware,agenttesla
3247273414427116826,10.127.0.102,204.79.197.203,80,tcp,-,94794,0,0,1610,35,1610,35,malware,agenttesla
-6070688466479579437,10.127.0.10,107.172.4.169,80,tcp,http,1563,1850793,1325,32183,698,1882976,2023,malware,agenttesla
6547220299193590858,10.127.0.136,8.8.8.8,53,udp,dns,23,302,2,123,2,425,4,normal,-
376904761658020553,10.127.0.136,173.231.16.76,443,tcp,http,104046,7214,14,1255,12,8469,26,malware,agenttesla
5745994488933619877,10.127.0.124,190.171.170.94,443,tcp,tls,212325,71792,1639,113868,1641,185660,3280,malware,agenttesla
2503148775270707808,10.127.0.68,20.234.34.18,443,tcp,-,43942,0,0,956,20,956,20,malware,agenttesla
-2526060294535137812,10.127.0.68,209.197.3.8,80,tcp,-,105826,0,0,1808,38,1808,38,malware,agenttesla
6469729260322651537,10.127.0.68,20.40.136.238,443,tcp,https,38057,0,0,20373,18,20373,18,malware,agenttesla
-8954676501581351330,10.127.0.68,104.237.62.211,443,tcp,-,14999,0,0,260,5,260,5,malware,agenttesla
8914998462458191525,10.127.0.68,64.185.227.155,443,tcp,-,103625,6927,11,1121,13,8048,24,malware,agenttesla
9201498886804602361,10.127.0.68,52.182.143.210,443,tcp,-,37906,0,0,644,14,644,14,malware,agenttesla
-3209792395441541623,10.127.0.68,117.18.237.29,80,tcp,-,0,0,0,92,2,92,2,malware,agenttesla
5775172553471435448,10.127.0.175,64.185.227.155,443,tcp,-,3129,84,2,190,4,274,6,malware,agenttesla
8353771400604357699,10.127.0.100,209.197.3.8,80,tcp,-,42072,0,0,624,12,624,12,malware,agenttesla
-5098730591301216754,10.127.0.100,8.8.8.8,53,udp,dns,2736,14355,98,6949,98,21304,196,normal,-
-3510221269640222010,10.127.0.100,93.184.220.29,80,tcp,-,170069,0,0,2910,60,2910,60,malware,agenttesla
8284402593168867650,10.127.0.100,173.223.113.164,443,tcp,-,114052,0,0,1932,42,1932,42,malware,agenttesla
2868824894564444649,10.127.0.100,173.223.113.131,80,tcp,-,94765,0,0,1610,35,1610,35,malware,agenttesla
3855290831061610399,10.127.0.100,204.79.197.203,80,tcp,-,94763,0,0,1610,35,1610,35,malware,agenttesla
1686686179062358135,10.127.0.106,64.185.227.155,443,tcp,tls,12920,6464,9,1006,14,7470,23,malware,agenttesla
830376483422988029,10.127.0.127,13.107.4.50,80,tcp,-,145395,69096,58,4857,86,73953,144,malware,agenttesla
-5091063614052832656,10.127.0.127,209.197.3.8,80,tcp,-,257494,0,0,4396,91,4396,91,malware,agenttesla
6949207756386001332,10.127.0.127,8.8.8.8,53,udp,dns,13222,21879,156,11500,161,33379,317,normal,-
-8710743839355227603,10.127.0.127,52.152.108.96,443,tcp,-,60067,0,0,1040,20,1040,20,malware,agenttesla
1492867376167008478,10.127.0.127,40.79.141.154,443,tcp,-,75998,0,0,1288,28,1288,28,malware,agenttesla
-5160432421488322705,10.127.0.127,173.223.113.164,443,tcp,-,75812,0,0,1288,28,1288,28,malware,agenttesla
-6715544085218141949,10.127.0.127,173.223.113.131,80,tcp,-,75812,0,0,1288,28,1288,28,malware,agenttesla
8857199890113971660,10.127.0.127,204.79.197.203,80,tcp,-,75812,0,0,1288,28,1288,28,malware,agenttesla
153749583762529073,10.127.0.117,52.152.110.14,443,tcp,-,171231,0,0,2808,54,2808,54,malware,agenttesla
2120229532770350313,10.127.0.117,107.172.4.169,80,tcp,http,1395,1850793,1325,31539,684,1882332,2009,malware,agenttesla
-784352620323764072,10.127.0.117,52.168.112.67,443,tcp,-,56857,0,0,966,21,966,21,malware,agenttesla
6253827486069155265,10.127.0.189,104.237.62.211,443,tcp,http,102229,7007,13,1063,12,8070,25,malware,agenttesla
-6528708848400593320,10.127.0.189,162.159.135.232,443,tcp,http,100463,5905,13,4074,13,9979,26,malware,agenttesla
1934695024682544367,10.127.0.54,52.168.112.66,443,tcp,-,94821,0,0,1610,35,1610,35,malware,agenttesla
-8808717492184397992,10.127.0.54,104.237.62.211,443,tcp,http,63797,6967,12,1023,11,7990,23,malware,agenttesla
1556749410875608498,10.127.0.54,149.154.167.220,443,tcp,http,218,7488,12,3647,11,11135,23,malware,agenttesla
-6495460371182891182,10.127.0.71,117.18.232.240,80,tcp,-,189431,0,0,1288,28,1288,28,malware,agenttesla
3719279752547406959,10.127.0.71,8.8.8.8,53,udp,dns,6800,11598,87,6165,88,17763,175,normal,-
1118187012854619042,10.127.0.71,13.89.179.8,443,tcp,-,37933,0,0,644,14,644,14,malware,agenttesla
3412005416136421014,10.127.0.71,20.54.89.15,443,tcp,-,30046,0,0,520,10,520,10,malware,agenttesla
-8390360425326917078,10.127.0.71,173.223.113.164,443,tcp,-,94775,0,0,1610,35,1610,35,malware,agenttesla
2831132397385943205,10.127.0.71,173.223.113.131,80,tcp,-,94766,0,0,1610,35,1610,35,malware,agenttesla
5627271886275377287,10.127.0.71,204.79.197.203,80,tcp,-,94795,0,0,1610,35,1610,35,malware,agenttesla
-8320991617891427029,10.127.0.71,209.197.3.8,80,tcp,-,94763,0,0,1610,35,1610,35,malware,agenttesla
7400770232544614719,10.127.0.113,91.235.128.141,587,tcp,-,100300,7238,29,8298,29,15536,58,malware,agenttesla
-9052918630979206720,10.127.0.23,8.8.8.8,53,udp,dns,52,302,2,123,2,425,4,normal,-
-6930164783990788311,10.127.0.23,104.237.62.211,443,tcp,http,61739,7028,12,1014,10,8042,22,malware,agenttesla
1192951292548638233,10.127.0.180,8.8.8.8,53,udp,dns,26048,18018,139,10941,156,28959,295,normal,-
1677960075170954925,10.127.0.180,20.189.173.9,443,tcp,-,42500,0,0,644,14,644,14,malware,agenttesla
6405867424329086716,10.127.0.122,8.8.8.8,53,udp,dns,18681,14231,107,8228,117,22459,224,normal,-
4474436996060127491,10.127.0.122,64.185.227.155,443,tcp,http,61618,7265,13,1014,10,8279,23,malware,agenttesla
3806208235414555401,10.127.0.102,64.185.227.155,443,tcp,http,102076,7076,14,1063,12,8139,26,malware,agenttesla
-1619657602463193082,10.127.0.101,20.189.173.11,443,tcp,-,38155,0,0,644,14,644,14,malware,agenttesla
-3686116713443119120,10.127.0.101,104.237.62.211,443,tcp,http,101060,6967,12,1011,11,7978,23,malware,agenttesla
-8728198186885030498,10.127.0.101,204.79.197.203,80,tcp,-,37906,0,0,644,14,644,14,malware,agenttesla
-1552008766788744596,10.127.0.101,93.184.221.240,80,tcp,-,75811,0,0,1288,28,1288,28,malware,agenttesla
-351107810020357977,10.127.0.11,8.8.8.8,53,udp,dns,11540,3007,26,1971,31,4978,57,normal,-
-5922347607931247548,10.127.0.224,198.46.174.170,80,tcp,http,1771,919590,658,16055,342,935645,1000,malware,agenttesla
2214947181014458132,10.127.0.3,8.8.8.8,53,udp,dns,1710,522,4,321,5,843,9,normal,-
4337701028002876541,10.127.0.3,104.237.62.211,443,tcp,tls,67027,20582,32,2749,28,23331,60,malware,agenttesla
-6806973774448044080,10.127.0.3,41.216.182.172,587,tcp,-,289,756,9,566,9,1322,18,malware,agenttesla
-3727818878544206567,10.127.0.26,8.8.8.8,53,udp,dns,27,126,1,59,1,185,2,normal,-
7082720763500278896,10.127.0.26,104.237.62.211,443,tcp,http,102260,6897,11,1060,11,7957,22,malware,agenttesla
-391510699881058407,10.127.0.216,8.8.8.8,53,udp,dns,743,586,5,325,5,911,10,normal,-
4082660820143489496,10.127.0.216,96.16.108.150,443,tcp,tls,1185,1498,34,2488,38,3986,72,malware,quakbot
-3276093394104322181,10.127.0.216,204.79.197.200,443,tcp,tls,146,7621,11,707,8,8328,19,malware,quakbot
-546399471503824491,10.127.0.113,23.222.53.128,443,tcp,tls,50352,1810,40,3552,59,5362,99,malware,quakbot
-7887484681011075912,10.127.0.113,204.79.197.200,443,tcp,tls,362,7621,11,707,8,8328,19,malware,quakbot
5990206632453295669,10.127.0.75,8.8.8.8,53,udp,dns,13103,17130,130,9251,131,26381,261,normal,-
203608167651622606,10.127.0.75,20.189.173.4,443,tcp,-,209267,0,0,3542,77,3542,77,malware,quakbot
-7859738290377806651,10.127.0.75,209.197.3.8,80,tcp,-,207755,0,0,3626,77,3626,77,malware,quakbot
-6592898729882502054,10.127.0.75,204.79.197.200,443,tcp,-,57340,8057,14,1208,16,9265,30,malware,quakbot
-4529471005697642643,10.127.0.60,23.222.53.128,443,tcp,-,94622,1009759,839,24285,448,1034044,1287,malware,quakbot
7239375876723621011,10.127.0.60,13.107.237.48,443,tcp,tls,75118,19747,25,2015,19,21762,44,malware,quakbot
-3872789135643203300,10.127.0.60,13.107.237.68,443,tcp,tls,93411,71821,65,3942,39,75763,104,malware,quakbot
2791902183802395478,10.127.0.60,20.205.115.81,443,tcp,tls,91883,8133,15,2115,17,10248,32,malware,quakbot
5512055454217961680,10.127.0.60,20.42.65.90,443,tcp,tls,181963,19493,33,19735,41,39228,74,malware,quakbot
7956899033699830715,10.127.0.60,204.79.197.200,443,tcp,tls,91081,9252,20,2026,16,11278,36,malware,quakbot
51279882125663732,10.127.0.60,224.0.0.251,5353,udp,-,3006,0,0,511,8,511,8,malware,quakbot
3842031605245938444,10.127.0.60,13.89.179.8,443,tcp,tls,624,13194,14,1862,18,15056,32,malware,quakbot
1054578819492561543,10.127.0.105,40.126.32.72,443,tcp,-,30110,0,0,520,10,520,10,malware,quakbot
4061811315223543538,10.127.0.105,20.190.160.22,443,tcp,-,30062,0,0,520,10,520,10,malware,quakbot
-1861126021436493676,10.127.0.105,40.125.122.151,443,tcp,-,15039,0,0,260,5,260,5,malware,quakbot
4155950400171540451,10.127.0.111,40.126.31.69,443,tcp,-,15012,0,0,260,5,260,5,malware,quakbot
1172329982205627574,10.127.0.66,176.113.115.136,431,tcp,-,45486,1354,15,6354,14,7708,29,malware,quakbot
-5154926377991701204,10.127.0.66,213.91.128.133,10060,tcp,-,177,956,4,547,5,1503,9,malware,quakbot
9215684606503676521,10.127.0.66,20.54.89.15,443,tcp,-,60115,0,0,1040,20,1040,20,malware,quakbot
-4532983958848098082,10.127.0.66,80.66.75.4,431,tcp,-,41828,1440,16,6433,16,7873,32,malware,quakbot
4733273898965592529,10.127.0.66,176.113.115.154,431,tcp,-,43746,6746,122,188187,154,194933,276,malware,quakbot
9113791566140606048,10.127.0.66,138.197.74.198,80,tcp,-,15025,0,0,260,5,260,5,malware,quakbot
282327081214065323,10.127.0.66,176.113.115.135,431,tcp,-,43906,7526,38,27613,42,35139,80,malware,quakbot
7703758148290724062,10.127.0.66,157.245.254.227,80,tcp,-,15032,0,0,260,5,260,5,malware,quakbot
2963596359970375568,10.127.0.66,176.113.115.155,431,tcp,-,46361,25328,103,82374,130,107702,233,malware,quakbot
-1524556781690982231,10.127.0.66,176.113.115.239,431,tcp,-,36577,4039,41,36273,44,40312,85,malware,quakbot
6973294321840883994,10.127.0.66,143.244.147.175,80,tcp,-,15060,0,0,260,5,260,5,malware,quakbot
6501412208417782676,10.127.0.126,8.8.8.8,53,udp,dns,2655,10882,80,5662,80,16544,160,normal,-
2980734268593327787,10.127.0.126,152.195.38.76,80,tcp,-,0,40,1,46,1,86,2,malware,quakbot
5835607603196090281,10.127.0.126,52.152.110.14,443,tcp,-,352618,0,0,6188,119,6188,119,malware,quakbot
-4444194361324454154,10.127.0.126,51.11.192.49,443,tcp,-,75811,0,0,1288,28,1288,28,malware,quakbot
2359963061059093285,10.127.0.126,8.238.21.126,80,tcp,-,75803,0,0,1288,28,1288,28,malware,quakbot
-53411153437130218,10.127.0.126,8.238.22.254,80,tcp,-,90845,0,0,1548,33,1548,33,malware,quakbot
1437801319178315464,10.127.0.126,173.223.113.164,443,tcp,-,132683,0,0,2254,49,2254,49,malware,quakbot
5613264853256318922,10.127.0.126,173.223.113.131,80,tcp,-,132670,0,0,2254,49,2254,49,malware,quakbot
3507883023964295955,10.127.0.126,131.253.33.203,80,tcp,-,75811,0,0,1288,28,1288,28,malware,quakbot
1930383955073859549,10.127.0.126,93.184.220.29,80,tcp,-,75827,0,0,1288,28,1288,28,malware,quakbot
3415078521417961611,10.127.0.105,213.91.128.133,10060,tcp,-,0,407,1,46,1,453,2,malware,quakbot
-77414815539155697,10.127.0.105,176.113.115.135,426,tcp,-,0,65,1,46,1,111,2,malware,quakbot
7002211846201522676,10.127.0.105,176.113.115.155,426,tcp,-,0,65,1,46,1,111,2,malware,quakbot
8771889385196739637,10.127.0.105,176.113.115.154,426,tcp,-,0,65,1,46,1,111,2,malware,quakbot
8184198291807036966,10.127.0.105,176.113.115.239,426,tcp,-,0,93,1,46,1,139,2,malware,quakbot
-6224943670424773676,10.127.0.105,80.66.75.4,426,tcp,-,0,65,1,46,1,111,2,malware,quakbot
-519629729371048020,10.127.0.105,176.113.115.136,426,tcp,-,1,95,1,46,1,141,2,malware,quakbot
8387241485388395748,10.127.0.104,40.77.2.164,443,tcp,-,55946,0,0,828,18,828,18,malware,quakbot
7748283336981273988,10.127.0.104,8.8.8.8,53,udp,dns,23056,23448,156,11942,168,35390,324,normal,-
7925298558844990385,10.127.0.104,52.152.110.14,443,tcp,-,42049,0,0,624,12,624,12,malware,quakbot
-3439195099012272228,10.127.0.104,8.238.21.126,80,tcp,-,215758,0,0,3678,78,3678,78,malware,quakbot
-5689590414466645466,10.127.0.104,224.0.0.251,5353,udp,-,9235,0,0,1382,21,1382,21,malware,quakbot
-3292591175471547658,10.127.0.104,138.197.74.198,80,tcp,-,15252,0,0,260,5,260,5,malware,quakbot
-6224289216703729725,10.127.0.104,96.16.108.150,443,tcp,-,95784,560276,472,20286,281,580562,753,malware,quakbot
-2158670111614622653,10.127.0.104,173.223.113.131,443,tcp,-,210417,106068,114,6428,69,112496,183,normal,-
-4370147276851534031,10.127.0.104,20.42.73.24,443,tcp,tls,287043,26528,63,70679,91,97207,154,malware,quakbot
-7321754306423629392,10.127.0.104,23.32.238.241,443,tcp,tls,90182,5424,13,4311,12,9735,25,malware,quakbot
-2777554008080116737,10.127.0.104,96.16.110.13,443,tcp,https,14163,7411,15,1097,11,8508,26,malware,quakbot
6229584360353795,10.127.0.104,13.107.237.68,443,tcp,tls,180386,102623,97,9150,72,111773,169,malware,quakbot
-1658209889715501421,10.127.0.104,13.107.237.48,443,tcp,tls,261925,120947,125,7883,79,128830,204,malware,quakbot
116721435323837933,10.127.0.104,20.190.145.141,443,tcp,tls,94254,70124,59,6937,39,77061,98,malware,quakbot
4160293287752146454,10.127.0.104,117.18.232.200,443,tcp,-,198672,50505,68,8770,57,59275,125,malware,quakbot
-4542444649979220314,10.127.0.104,152.199.39.242,443,tcp,-,106843,6465,16,1700,13,8165,29,malware,quakbot
511383328801034702,10.127.0.104,20.205.115.81,443,tcp,tls,91482,8025,15,2499,15,10524,30,malware,quakbot
-2999841511329565294,10.127.0.104,152.199.39.108,443,tcp,-,166744,15692,38,3492,28,19184,66,malware,quakbot
-9184686047967173274,10.127.0.104,204.79.197.200,443,tcp,tls,90202,9138,18,1977,15,11115,33,malware,quakbot
-115702497120233605,10.127.0.104,20.50.201.200,443,tcp,-,56851,0,0,966,21,966,21,malware,quakbot
-3868774204997505964,10.127.0.104,93.184.220.29,80,tcp,-,56859,0,0,966,21,966,21,malware,quakbot
7735551166475131592,10.127.0.109,93.184.221.240,80,tcp,-,272477,0,0,4644,99,4644,99,malware,quakbot
6580925030413045547,10.127.0.109,13.107.4.50,80,tcp,-,124835,0,0,2130,45,2130,45,malware,quakbot
461043165043143694,10.127.0.109,8.8.8.8,53,udp,dns,24966,10735,71,6285,86,17020,157,normal,-
369553158680979939,10.127.0.109,20.189.173.15,443,tcp,-,94760,0,0,1610,35,1610,35,malware,quakbot
7562333236447112409,10.127.0.109,173.223.113.164,443,tcp,-,113717,0,0,1932,42,1932,42,malware,quakbot
-427104190118320060,10.127.0.109,173.223.113.131,80,tcp,-,113734,0,0,1932,42,1932,42,malware,quakbot
-5228651285432550313,10.127.0.109,131.253.33.203,80,tcp,-,94763,0,0,1610,35,1610,35,malware,quakbot
-6806150354322986719,10.127.0.109,93.184.220.29,80,tcp,-,94765,0,0,1610,35,1610,35,malware,quakbot
-3749289209275115092,10.127.0.125,8.8.8.8,53,udp,dns,2099,7885,58,4104,58,11989,116,normal,-
-7111259080519014773,10.127.0.125,52.152.110.14,443,tcp,-,180263,0,0,3120,60,3120,60,malware,quakbot
2838759138681714206,10.127.0.125,20.42.73.27,443,tcp,-,37904,0,0,644,14,644,14,malware,quakbot
-4536848253591411994,10.127.0.125,173.223.113.164,443,tcp,-,56857,0,0,966,21,966,21,malware,quakbot
-4637436564436578846,10.127.0.125,173.223.113.131,80,tcp,-,94795,0,0,1610,35,1610,35,malware,quakbot
-1841297075547144764,10.127.0.125,204.79.197.203,80,tcp,-,56856,0,0,966,21,966,21,malware,quakbot
-8761987706547760939,10.127.0.125,93.184.221.240,80,tcp,-,125023,0,0,2130,45,2130,45,malware,quakbot
-4889544410552879844,10.127.0.190,46.3.199.41,80,tcp,-,0,40,1,46,1,86,2,malware,quakbot
-767113732262064387,10.127.0.190,52.109.77.0,443,tcp,-,18953,0,0,322,7,322,7,malware,quakbot
1309368066870818058,10.127.0.163,146.190.116.245,80,tcp,-,15052,0,0,260,5,260,5,malware,quakbot
-2017319928532677912,10.127.0.163,134.209.216.163,80,tcp,-,15044,0,0,260,5,260,5,malware,quakbot
-1667770173485134199,10.127.0.163,162.243.186.39,80,tcp,-,15012,0,0,260,5,260,5,malware,quakbot
8653543399807636067,10.127.0.163,142.93.250.152,80,tcp,-,15043,0,0,260,5,260,5,malware,quakbot
5726432164394021542,10.127.0.163,161.35.58.146,80,tcp,-,15040,0,0,260,5,260,5,malware,quakbot
-7877665880501468403,10.127.0.104,209.197.3.8,80,tcp,-,52899,0,0,904,19,904,19,malware,quakbot
-4033517962193885977,10.127.0.104,20.54.89.15,443,tcp,-,30085,0,0,520,10,520,10,malware,quakbot
-7947034687936958452,10.127.0.104,173.223.113.164,443,tcp,-,37922,0,0,644,14,644,14,malware,quakbot
4988095235734549543,10.127.0.167,13.107.42.12,443,tcp,tls,4096,19510,28,1516,18,21026,46,malware,quakbot
-7505615757681443240,10.127.0.204,138.197.74.198,80,tcp,-,9794,0,0,152,3,152,3,malware,quakbot
-5898002967742130261,10.127.0.204,157.245.254.227,80,tcp,-,1957,120,3,152,3,272,6,malware,quakbot
911781956008120705,10.127.0.204,143.244.147.175,80,tcp,-,10141,0,0,152,3,152,3,malware,quakbot
8239451926937681842,10.127.0.186,209.197.3.8,80,tcp,-,166659,0,0,2836,61,2836,61,malware,quakbot
-3624540743306897867,10.127.0.186,93.184.220.29,80,tcp,-,45094,0,0,780,15,780,15,malware,quakbot
1832979223666964214,10.127.0.186,8.8.8.8,53,udp,dns,1785,6680,45,3245,45,9925,90,normal,-
-3230631665572502998,10.127.0.186,173.223.113.164,443,tcp,-,75811,0,0,1288,28,1288,28,malware,quakbot
2425127886257385896,10.127.0.186,131.253.33.203,80,tcp,-,75812,0,0,1288,28,1288,28,malware,quakbot
-2022939251212402270,10.127.0.100,23.222.53.128,443,tcp,https,100990,1007285,793,23450,430,1030735,1223,malware,quakbot
-7459194529363135338,10.127.0.100,13.107.237.48,443,tcp,tls,75143,19786,26,2245,24,22031,50,malware,quakbot
-7939652406051194421,10.127.0.100,13.107.237.68,443,tcp,tls,75125,89096,76,6408,61,95504,137,malware,quakbot
-6102280846787058940,10.127.0.100,20.205.115.81,443,tcp,tls,98356,8025,15,2117,17,10142,32,malware,quakbot
1853218007063195485,10.127.0.100,40.79.197.35,443,tcp,tls,291718,24248,41,18569,49,42817,90,malware,quakbot
-3584955902540112400,10.127.0.100,204.79.197.200,443,tcp,tls,97486,9217,20,2068,17,11285,37,malware,quakbot
-5331037479109361512,10.127.0.100,224.0.0.251,5353,udp,-,3728,0,0,453,7,453,7,malware,quakbot
-6573537215334138047,10.127.0.100,51.11.192.50,443,tcp,tls,426,13168,14,1678,14,14846,28,malware,quakbot
8269065920496889520,10.127.0.66,146.190.116.245,80,tcp,-,15001,0,0,260,5,260,5,malware,quakbot
-788197272714429152,10.127.0.66,134.209.216.163,80,tcp,-,15060,0,0,260,5,260,5,malware,quakbot
-4804774838003111895,10.127.0.66,52.152.108.96,443,tcp,-,30084,0,0,520,10,520,10,malware,quakbot
-8760411075692728680,10.127.0.66,52.168.112.66,443,tcp,-,37903,0,0,644,14,644,14,malware,quakbot
-3012507245627894907,10.127.0.66,162.243.186.39,80,tcp,-,15035,0,0,260,5,260,5,malware,quakbot
-580042788055390258,10.127.0.66,142.93.250.152,80,tcp,-,15038,0,0,260,5,260,5,malware,quakbot
8287772635035724876,10.127.0.66,161.35.58.146,80,tcp,-,15046,0,0,260,5,260,5,malware,quakbot
-2523254565054833893,10.127.0.116,85.239.54.233,80,tcp,-,15039,0,0,260,5,260,5,malware,quakbot
-8962143858800120308,10.127.0.8,204.79.197.200,443,tcp,tls,49126,7621,11,753,9,8374,20,malware,quakbot
1791748487403544776,10.127.0.80,85.239.54.233,80,tcp,-,15018,0,0,260,5,260,5,malware,quakbot
-3934105881445453143,10.127.0.80,20.54.89.15,443,tcp,-,30046,0,0,520,10,520,10,malware,quakbot
-5840517045677817207,10.127.0.80,20.50.80.209,443,tcp,-,56831,0,0,966,21,966,21,malware,quakbot
969967605843982098,10.127.0.80,209.197.3.8,80,tcp,-,143744,0,0,2452,52,2452,52,malware,quakbot
4928981879254153909,10.127.0.80,173.223.113.164,443,tcp,-,132785,0,0,2254,49,2254,49,malware,quakbot
6959548062568243068,10.127.0.80,173.223.113.131,80,tcp,-,132829,0,0,2254,49,2254,49,malware,quakbot
4928367791276213853,10.127.0.80,204.79.197.203,80,tcp,-,56814,0,0,966,21,966,21,malware,quakbot
3729756757220311624,10.127.0.173,23.222.53.128,443,tcp,-,39561,749,17,1848,31,2597,48,malware,quakbot
4741599833853610962,10.127.0.173,204.79.197.200,443,tcp,tls,336,7621,11,707,8,8328,19,malware,quakbot
6203036280323373532,10.127.0.123,13.107.42.12,443,tcp,tls,5098,19574,28,1516,18,21090,46,malware,quakbot
2086007550024724836,10.127.0.171,8.8.8.8,53,udp,dns,4735,12346,97,6913,98,19259,195,normal,-
4961123178599313869,10.127.0.171,93.184.220.29,80,tcp,-,52905,0,0,904,19,904,19,malware,quakbot
213260798602471772,10.127.0.171,93.184.221.240,80,tcp,-,71901,0,0,1226,26,1226,26,malware,quakbot
-7234890362545400309,10.127.0.50,8.238.20.126,80,tcp,-,37895,0,0,644,14,644,14,malware,quakbot
3976903665998903456,10.127.0.50,13.89.179.8,443,tcp,-,18952,0,0,322,7,322,7,malware,quakbot
-40726147277595083,10.127.0.50,173.223.113.131,80,tcp,-,18953,0,0,322,7,322,7,malware,quakbot
-2071906418569624298,10.127.0.50,204.79.197.203,80,tcp,-,18953,0,0,322,7,322,7,malware,quakbot
882168555973300207,10.127.0.108,8.8.8.8,53,udp,dns,4495,17639,127,8876,127,26515,254,normal,-
-4131564931172376377,10.127.0.108,93.184.220.29,80,tcp,-,226785,0,0,3876,81,3876,81,malware,quakbot
655835596033799757,10.127.0.108,52.168.117.169,443,tcp,-,56856,0,0,966,21,966,21,malware,quakbot
-4610890532527305603,10.127.0.108,8.247.210.254,80,tcp,-,113710,0,0,1932,42,1932,42,malware,quakbot
-1163796125476972040,10.127.0.108,173.223.113.164,443,tcp,-,151615,0,0,2576,56,2576,56,malware,quakbot
2247481233032290282,10.127.0.108,173.223.113.131,80,tcp,-,151623,0,0,2576,56,2576,56,malware,quakbot
1531755052567295190,10.127.0.108,204.79.197.203,80,tcp,-,56857,0,0,966,21,966,21,malware,quakbot
-8586387510363921545,10.127.0.120,8.8.8.8,53,udp,dns,88770,13095,94,8219,114,21314,208,normal,-
-5295686071740765959,10.127.0.120,93.184.220.29,80,tcp,-,96259,0,0,1610,35,1610,35,malware,quakbot
9142166326464823218,10.127.0.120,209.197.3.8,80,tcp,-,148071,0,0,2514,54,2514,54,malware,quakbot
4674440136044965041,10.127.0.120,173.223.113.164,443,tcp,-,95172,0,0,1610,35,1610,35,malware,quakbot
4573851825199798189,10.127.0.120,173.223.113.131,80,tcp,-,97153,0,0,1610,35,1610,35,malware,quakbot
3327842285784527272,10.127.0.120,131.253.33.203,80,tcp,-,78198,0,0,1288,28,1288,28,malware,quakbot
846442768003152847,10.127.0.109,152.195.38.76,80,tcp,-,0,40,1,46,1,86,2,malware,quakbot
4638624248949001487,10.127.0.24,8.8.8.8,53,udp,dns,3402,2697,30,1932,30,4629,60,normal,-
-3897052862399103145,10.127.0.24,132.226.8.169,80,tcp,http,101397,485,5,427,6,912,11,malware,snakekeylogger
-5704092749835766591,10.127.0.127,23.111.184.154,80,tcp,-,105219,0,0,1820,35,1820,35,malware,snakekeylogger
2542038102931607489,10.127.0.127,152.195.38.76,80,tcp,-,0,40,1,46,1,86,2,malware,snakekeylogger
5366118373697307477,10.127.0.136,158.101.44.242,80,tcp,http,65287,758,5,387,5,1145,10,malware,snakekeylogger
5671069467699497489,10.127.0.4,8.8.8.8,53,udp,dns,24,176,1,64,1,240,2,normal,-
6361069499517224282,10.127.0.4,132.226.8.169,80,tcp,http,65533,758,5,433,6,1191,11,malware,snakekeylogger
5714563975390141791,10.127.0.123,193.122.6.168,80,tcp,http,101703,798,6,433,6,1231,12,malware,snakekeylogger
1071511977152075765,10.127.0.221,8.8.8.8,53,udp,dns,245,2416,19,1244,19,3660,38,normal,-
-7481695660091886878,10.127.0.221,193.122.130.0,80,tcp,http,65175,758,5,387,5,1145,10,malware,snakekeylogger
8940675238587210812,10.127.0.170,20.189.173.15,443,tcp,-,18953,0,0,322,7,322,7,malware,snakekeylogger
6877023794064622734,10.127.0.170,204.79.197.203,80,tcp,-,18953,0,0,322,7,322,7,malware,snakekeylogger
-3541673635953148369,10.127.0.170,8.247.210.254,80,tcp,-,18953,0,0,322,7,322,7,malware,snakekeylogger
-1953782272095323547,10.127.0.170,132.226.247.73,80,tcp,http,65415,445,4,381,5,826,9,malware,snakekeylogger
3856805009468038153,10.127.0.121,193.122.130.0,80,tcp,http,65237,758,5,433,6,1191,11,malware,snakekeylogger
4581012288115708692,10.127.0.134,8.8.8.8,53,udp,dns,590,827,7,458,7,1285,14,normal,-
2174732460627572864,10.127.0.134,132.226.8.169,80,tcp,http,74094,758,5,387,5,1145,10,malware,snakekeylogger
-4798162286398073495,10.127.0.17,132.226.247.73,80,tcp,http,101255,485,5,427,6,912,11,malware,snakekeylogger
-503938829011319750,10.127.0.105,209.197.3.8,80,tcp,-,218909,0,0,3752,77,3752,77,malware,snakekeylogger
7827975190260872903,10.127.0.105,132.226.8.169,80,tcp,http,100771,485,5,427,6,912,11,malware,snakekeylogger
312632978216535844,10.127.0.105,52.152.110.14,443,tcp,-,450886,0,0,7800,150,7800,150,malware,snakekeylogger
-6803873175222236213,10.127.0.105,20.50.201.201,443,tcp,-,113713,0,0,1932,42,1932,42,malware,snakekeylogger
-8514285067908496224,10.127.0.105,204.79.197.203,80,tcp,-,227458,0,0,3864,84,3864,84,malware,snakekeylogger
-5811300198359088416,10.127.0.105,93.184.220.29,80,tcp,-,113716,0,0,1932,42,1932,42,malware,snakekeylogger
2917311555380476761,10.127.0.119,20.123.141.233,443,tcp,-,0,40,1,0,0,40,1,malware,snakekeylogger
-2677924152865424194,10.127.0.119,193.122.6.168,80,tcp,http,100082,485,5,427,6,912,11,malware,snakekeylogger
-1115084238456118378,10.127.0.23,193.122.6.168,80,tcp,http,65051,758,5,387,5,1145,10,malware,snakekeylogger
742471617944914471,10.127.0.170,23.111.184.154,80,tcp,-,64116,0,0,1016,20,1016,20,malware,snakekeylogger
-4287813276231637777,10.127.0.115,8.8.8.8,53,udp,dns,18908,15458,110,8414,120,23872,230,normal,-
-4796811484837777264,10.127.0.115,107.172.4.169,80,tcp,-,16294,1834849,1319,55243,907,1890092,2226,malware,snakekeylogger
3724251195691508712,10.127.0.115,132.226.247.73,80,tcp,http,115700,485,5,687,11,1172,16,malware,snakekeylogger
5559519463288328852,10.127.0.115,93.184.220.29,80,tcp,-,147953,0,0,2514,54,2514,54,malware,snakekeylogger
-1892023249011977970,10.127.0.115,8.247.210.254,80,tcp,-,170906,0,0,2898,63,2898,63,malware,snakekeylogger
4624854560264487589,10.127.0.115,8.253.208.113,80,tcp,-,30044,0,0,520,10,520,10,malware,snakekeylogger
-5288831183627574352,10.127.0.65,93.184.220.29,80,tcp,-,45174,0,0,780,15,780,15,malware,snakekeylogger
4000580182379737428,10.127.0.65,132.226.8.169,80,tcp,http,100754,485,5,427,6,912,11,malware,snakekeylogger
8012424479094477036,10.127.0.75,132.226.8.169,80,tcp,http,100740,485,5,427,6,912,11,malware,snakekeylogger
5485279809816276584,10.127.0.123,209.197.3.8,80,tcp,-,225931,0,0,3960,81,3960,81,malware,snakekeylogger
-3943361110445413883,10.127.0.123,40.126.31.67,443,tcp,-,14989,0,0,260,5,260,5,malware,snakekeylogger
5297200832628386089,10.127.0.123,104.208.16.89,443,tcp,-,56859,0,0,966,21,966,21,malware,snakekeylogger
8063582908031275232,10.127.0.123,173.223.113.164,443,tcp,-,56857,0,0,966,21,966,21,malware,snakekeylogger
-3661074351561202893,10.127.0.94,8.8.8.8,53,udp,dns,36,176,1,64,1,240,2,normal,-
4840388108099989378,10.127.0.94,132.226.247.73,80,tcp,http,65471,758,5,433,6,1191,11,malware,snakekeylogger
7072423112588882204,10.127.0.127,132.226.247.73,80,tcp,http,101059,758,5,433,6,1191,11,malware,snakekeylogger
-725526257759597433,10.127.0.129,8.8.8.8,53,udp,dns,4791,8921,73,5065,73,13986,146,normal,-
-7884621612907481789,10.127.0.129,8.238.21.126,80,tcp,-,52921,0,0,904,19,904,19,malware,snakekeylogger
7198042794542142266,10.127.0.129,20.50.73.11,443,tcp,-,37906,0,0,644,14,644,14,malware,snakekeylogger
-3099776736021717119,10.127.0.129,158.101.44.242,80,tcp,http,66312,445,4,381,5,826,9,malware,snakekeylogger
-5789137146999064645,10.127.0.129,173.223.113.164,443,tcp,-,56856,0,0,966,21,966,21,malware,snakekeylogger
8084849055191472762,10.127.0.129,173.223.113.131,80,tcp,-,37906,0,0,644,14,644,14,malware,snakekeylogger
-3719055442213084154,10.127.0.129,131.253.33.203,80,tcp,-,37905,0,0,644,14,644,14,malware,snakekeylogger
4654589404087415749,10.127.0.172,8.8.8.8,53,udp,dns,26405,15970,127,9654,139,25624,266,normal,-
5344589435905142542,10.127.0.172,132.226.8.169,80,tcp,http,101358,798,6,433,6,1231,12,malware,snakekeylogger
4067452118822215977,10.127.0.97,208.67.105.179,80,tcp,http,766,1013957,727,17718,378,1031675,1105,malware,snakekeylogger
304887972489422558,10.127.0.97,8.8.8.8,53,udp,dns,36,176,1,64,1,240,2,normal,-
6158678526500126132,10.127.0.97,132.226.247.73,80,tcp,http,65472,758,5,433,6,1191,11,malware,snakekeylogger
-5306646874374807919,10.127.0.122,162.19.139.184,12222,tcp,tls,88774,9053,21,2522,21,11575,42,malware,snakekeylogger
-107011655955022281,10.127.0.122,20.190.159.75,443,tcp,-,15046,0,0,260,5,260,5,malware,snakekeylogger
3804774684636298799,10.127.0.122,13.89.179.8,443,tcp,-,113932,0,0,1932,42,1932,42,malware,snakekeylogger
49838167511956684,10.127.0.122,132.226.8.169,80,tcp,-,15031,0,0,260,5,260,5,malware,snakekeylogger
-6187086095369761326,10.127.0.122,132.226.247.73,80,tcp,-,15043,0,0,260,5,260,5,malware,snakekeylogger
8783957046754142484,10.127.0.122,209.197.3.8,80,tcp,-,228612,0,0,3864,84,3864,84,malware,snakekeylogger
-9193369501549732752,10.127.0.122,193.122.130.0,80,tcp,-,15031,0,0,260,5,260,5,malware,snakekeylogger
5916961353022145070,10.127.0.122,193.122.6.168,80,tcp,-,15031,0,0,260,5,260,5,malware,snakekeylogger
-4395123517763062958,10.127.0.122,158.101.44.242,80,tcp,-,15046,0,0,260,5,260,5,malware,snakekeylogger
-3625364074943252267,10.127.0.126,195.133.40.130,80,tcp,-,15046,0,0,260,5,260,5,malware,snakekeylogger
-3923115063869872563,10.127.0.7,198.46.174.164,80,tcp,http,2134,1107776,793,19798,421,1127574,1214,malware,snakekeylogger
8159369521936436508,10.127.0.7,8.8.8.8,53,udp,dns,24,176,1,64,1,240,2,normal,-
-8265156705131933741,10.127.0.7,132.226.8.169,80,tcp,http,65511,758,5,433,6,1191,11,malware,snakekeylogger
-7567240272896956278,10.127.0.179,8.8.8.8,53,udp,dns,166,1907,13,924,13,2831,26,normal,-
-6877240241079229485,10.127.0.179,132.226.8.169,80,tcp,http,65547,758,5,433,6,1191,11,malware,snakekeylogger
1521228425849925892,10.127.0.163,158.101.44.242,80,tcp,http,65342,445,4,381,5,826,9,malware,snakekeylogger
1672828506266292843,10.127.0.106,158.101.44.242,80,tcp,-,15022,0,0,260,5,260,5,malware,snakekeylogger
-5619010869572641953,10.127.0.106,193.122.6.168,80,tcp,-,15012,0,0,260,5,260,5,malware,snakekeylogger
-1422458558658778549,10.127.0.106,132.226.8.169,80,tcp,-,15030,0,0,260,5,260,5,malware,snakekeylogger
3741331963534198232,10.127.0.106,132.226.247.73,80,tcp,-,15015,0,0,260,5,260,5,malware,snakekeylogger
6894586132359144677,10.127.0.106,193.122.130.0,80,tcp,-,15062,0,0,260,5,260,5,malware,snakekeylogger
3357939855385764165,10.127.0.115,158.101.44.242,80,tcp,http,116052,798,6,693,11,1491,17,malware,snakekeylogger
-3823239048900046349,10.127.0.191,45.159.189.105,80,tcp,-,180384,6694,22,2996,35,9690,57,malware,snakekeylogger
-2912695917874319984,10.127.0.191,157.240.221.35,443,tcp,tls,25340,303079,238,13910,134,316989,372,malware,snakekeylogger
-5617213736601139092,10.127.0.191,158.101.44.242,80,tcp,http,101522,485,5,427,6,912,11,malware,snakekeylogger
-1752314410356638688,10.127.0.173,132.226.8.169,80,tcp,http,100823,485,5,427,6,912,11,malware,snakekeylogger
4397773040943354163,10.127.0.114,158.101.44.242,80,tcp,http,65347,758,5,387,5,1145,10,malware,snakekeylogger
2168429517393770979,10.127.0.71,193.122.130.0,80,tcp,http,65239,758,5,387,5,1145,10,malware,snakekeylogger
-1326391441091433948,10.127.0.61,8.8.8.8,53,udp,dns,2036,12873,99,6855,99,19728,198,normal,-
968290893923151076,10.127.0.61,20.189.173.9,443,tcp,-,56903,0,0,966,21,966,21,malware,snakekeylogger
2702901457895910966,10.127.0.61,132.226.247.73,80,tcp,http,100624,485,5,427,6,912,11,malware,snakekeylogger
-2325949221234400433,10.127.0.61,8.238.21.126,80,tcp,-,114379,0,0,1932,42,1932,42,malware,snakekeylogger
5335885889198973004,10.127.0.191,132.226.8.169,80,tcp,http,101353,798,6,479,7,1277,13,malware,snakekeylogger
6548660185927010446,10.127.0.124,132.226.8.169,80,tcp,http,65544,758,5,433,6,1191,11,malware,snakekeylogger
-8495953432153190038,10.127.0.107,158.101.44.242,80,tcp,http,65349,445,4,381,5,826,9,malware,snakekeylogger
-506441028380690397,10.127.0.177,193.122.6.168,80,tcp,http,66052,758,5,387,5,1145,10,malware,snakekeylogger
-1138277920797646181,10.127.0.98,158.101.44.242,80,tcp,http,65320,445,4,381,5,826,9,malware,snakekeylogger
-6982487119488305446,10.127.0.70,8.238.20.126,80,tcp,-,37937,0,0,644,14,644,14,malware,snakekeylogger
3812753440959591271,10.127.0.70,8.8.8.8,53,udp,dns,1910,10450,81,5684,82,16134,163,normal,-
3207960856502375476,10.127.0.70,13.89.179.9,443,tcp,-,37903,0,0,644,14,644,14,malware,snakekeylogger
7007414870612502633,10.127.0.70,52.152.110.14,443,tcp,-,283565,0,0,5096,98,5096,98,malware,snakekeylogger
3935968797162472143,10.127.0.70,132.226.247.73,80,tcp,http,100634,485,5,427,6,912,11,malware,snakekeylogger
-5279240529125537801,10.127.0.70,173.223.113.164,443,tcp,-,75808,0,0,1288,28,1288,28,malware,snakekeylogger
6020885945103990138,10.127.0.70,173.223.113.131,80,tcp,-,76085,0,0,1288,28,1288,28,malware,snakekeylogger
-4837149383301724400,10.127.0.70,204.79.197.203,80,tcp,-,75867,0,0,1288,28,1288,28,malware,snakekeylogger
-8929713560424679420,10.127.0.70,8.238.177.126,80,tcp,-,37938,0,0,644,14,644,14,malware,snakekeylogger
-7468351959768553704,10.127.0.66,132.226.247.73,80,tcp,http,100671,485,5,427,6,912,11,malware,snakekeylogger
5799312465291914886,10.127.0.5,8.8.8.8,53,udp,dns,24,176,1,64,1,240,2,normal,-
5922527821494795758,10.127.0.5,132.226.247.73,80,tcp,http,66442,758,5,433,6,1191,11,malware,snakekeylogger
-4810784309638854005,10.127.0.75,158.101.44.242,80,tcp,http,100443,485,5,427,6,912,11,malware,snakekeylogger
1572168587791027000,10.127.0.108,132.226.8.169,80,tcp,http,115800,485,5,687,11,1172,16,malware,snakekeylogger
-7888819599051908369,10.127.0.108,40.79.141.152,443,tcp,-,94763,0,0,1610,35,1610,35,malware,snakekeylogger
-8140456606676338816,10.127.0.108,209.197.3.8,80,tcp,-,416087,0,0,7168,154,7168,154,malware,snakekeylogger
5977351592982652766,10.127.0.108,20.190.159.0,443,tcp,-,30045,0,0,520,10,520,10,malware,snakekeylogger
5872674601548090017,10.127.0.108,131.253.33.203,80,tcp,-,94763,0,0,1610,35,1610,35,malware,snakekeylogger
-1656258308775875603,10.127.0.128,8.8.8.8,53,udp,dns,43235,15349,124,8630,125,23979,249,normal,-
-7768739292178228375,10.127.0.128,20.42.65.85,443,tcp,-,56936,0,0,966,21,966,21,malware,snakekeylogger
4680845587059351976,10.127.0.128,173.223.113.164,443,tcp,-,94762,0,0,1610,35,1610,35,malware,snakekeylogger
3125733923329532732,10.127.0.128,173.223.113.131,80,tcp,-,113718,0,0,1932,42,1932,42,malware,snakekeylogger
8140582940672360342,10.127.0.128,204.79.197.203,80,tcp,-,56860,0,0,966,21,966,21,malware,snakekeylogger
-1409323180510075846,10.127.0.128,209.197.3.8,80,tcp,-,170574,0,0,2898,63,2898,63,malware,snakekeylogger
-123438449872740018,10.127.0.128,132.226.8.169,80,tcp,http,65509,445,4,381,5,826,9,malware,snakekeylogger
-5749652994777627348,10.127.0.128,84.53.175.11,80,tcp,-,0,40,1,46,1,86,2,malware,snakekeylogger
-3335210550796400581,10.127.0.193,192.227.162.28,80,tcp,http,26520,1892968,1355,32602,707,1925570,2062,malware,snakekeylogger
821328830710550221,10.127.0.193,132.226.247.73,80,tcp,http,101904,485,5,427,6,912,11,malware,snakekeylogger
3461446577081899177,10.127.0.204,8.8.8.8,53,udp,dns,9,176,1,64,1,240,2,normal,-
-3311161284164588637,10.127.0.204,158.101.44.242,80,tcp,http,65287,758,5,387,5,1145,10,malware,snakekeylogger
5062454328845190280,10.127.0.3,193.122.130.0,80,tcp,http,100936,798,6,433,6,1231,12,malware,snakekeylogger
2677741325282349323,10.127.0.12,132.226.247.73,80,tcp,http,65447,758,5,387,5,1145,10,malware,snakekeylogger
-8397829705281860656,10.127.0.176,132.226.247.73,80,tcp,http,69285,445,4,381,5,826,9,malware,snakekeylogger
-721557605812015196,10.127.0.189,8.238.22.254,80,tcp,-,246938,0,0,4198,88,4198,88,malware,snakekeylogger
-2164520007195442563,10.127.0.189,132.226.8.169,80,tcp,http,100858,485,5,427,6,912,11,malware,snakekeylogger
5204465257175766869,10.127.0.189,40.126.32.136,443,tcp,-,15046,0,0,260,5,260,5,malware,snakekeylogger
9182379018166152972,10.127.0.189,104.46.162.224,443,tcp,-,105092,0,0,966,21,966,21,malware,snakekeylogger
-8434060744549239992,10.127.0.189,40.126.32.68,443,tcp,-,15031,0,0,260,5,260,5,malware,snakekeylogger
-1020729463285192780,10.127.0.189,131.253.33.203,80,tcp,-,56857,0,0,966,21,966,21,malware,snakekeylogger
6790247177511749093,10.127.0.52,132.226.247.73,80,tcp,http,65451,445,4,381,5,826,9,malware,snakekeylogger
6932697163371870958,10.127.0.73,132.226.247.73,80,tcp,http,101219,485,5,427,6,912,11,malware,snakekeylogger
1995152065193024650,10.127.0.99,158.101.44.242,80,tcp,http,65341,758,5,387,5,1145,10,malware,snakekeylogger
7382863772994496511,10.127.0.55,132.226.247.73,80,tcp,http,100636,485,5,427,6,912,11,malware,snakekeylogger
1133865507513684746,10.127.0.96,8.8.8.8,53,udp,dns,36,176,1,64,1,240,2,normal,-
3156083354154866113,10.127.0.96,132.226.8.169,80,tcp,http,68739,758,5,433,6,1191,11,malware,snakekeylogger
-2844979546801520798,10.127.0.124,132.226.247.73,80,tcp,http,65408,445,4,381,5,826,9,malware,snakekeylogger
7382164127487269982,10.127.0.166,8.8.8.8,53,udp,dns,10842,8018,56,4379,61,12397,117,normal,-
-3983830721005950727,10.127.0.166,20.50.73.11,443,tcp,-,18952,0,0,322,7,322,7,malware,snakekeylogger
8072164159304996775,10.127.0.166,132.226.8.169,80,tcp,-,15037,0,0,260,5,260,5,malware,snakekeylogger
1835239896423278765,10.127.0.166,132.226.247.73,80,tcp,-,15008,0,0,260,5,260,5,malware,snakekeylogger
-1171043509756692661,10.127.0.166,193.122.130.0,80,tcp,-,15000,0,0,260,5,260,5,malware,snakekeylogger
-7525102936683561420,10.127.0.166,193.122.6.168,80,tcp,-,15015,0,0,260,5,260,5,malware,snakekeylogger
-7279292849479483449,10.127.0.166,158.101.44.242,80,tcp,-,7046,0,0,208,4,208,4,malware,snakekeylogger
-7480068121032854928,10.127.0.162,93.184.221.240,80,tcp,-,412223,0,0,6972,147,6972,147,malware,snakekeylogger
-1899675130003680106,10.127.0.162,132.226.8.169,80,tcp,http,100823,485,5,427,6,912,11,malware,snakekeylogger
-2342479043503947051,10.127.0.162,20.224.254.73,443,tcp,-,0,40,1,0,0,40,1,malware,snakekeylogger
3790549521591757531,10.127.0.162,52.152.110.14,443,tcp,-,603368,0,0,10712,206,10712,206,malware,snakekeylogger
7414968378288624811,10.127.0.162,13.69.239.72,443,tcp,-,76537,0,0,1288,28,1288,28,malware,snakekeylogger
5414656641763986106,10.127.0.62,192.227.162.28,80,tcp,http,41078,1892968,1355,32418,703,1925386,2058,malware,snakekeylogger
-4909614345673208538,10.127.0.62,193.122.130.0,80,tcp,http,100308,485,5,427,6,912,11,malware,snakekeylogger
7685101860505293357,10.127.0.108,158.101.44.242,80,tcp,-,15024,0,0,260,5,260,5,malware,snakekeylogger
-7911172441102473609,10.127.0.108,193.122.6.168,80,tcp,-,15038,0,0,260,5,260,5,malware,snakekeylogger
1005383912176181079,10.127.0.108,132.226.247.73,80,tcp,-,15015,0,0,260,5,260,5,malware,snakekeylogger
5045129794631066478,10.127.0.108,193.122.130.0,80,tcp,-,15030,0,0,260,5,260,5,malware,snakekeylogger
-7696213779568193110,10.127.0.71,107.172.4.169,80,tcp,http,5603,1834889,1320,37061,758,1871950,2078,malware,snakekeylogger
-8873673767151441083,10.127.0.71,132.226.247.73,80,tcp,http,102304,798,6,433,6,1231,12,malware,snakekeylogger
2363999402361854350,10.127.0.182,132.226.8.169,80,tcp,-,15044,0,0,260,5,260,5,malware,snakekeylogger
-1788463120296899974,10.127.0.182,132.226.247.73,80,tcp,-,15114,0,0,260,5,260,5,malware,snakekeylogger
7217671784397066991,10.127.0.182,193.122.130.0,80,tcp,-,15031,0,0,260,5,260,5,malware,snakekeylogger
-3164770723375463628,10.127.0.182,193.122.6.168,80,tcp,-,15015,0,0,260,5,260,5,malware,snakekeylogger
541390805419562765,10.127.0.182,158.101.44.242,80,tcp,-,7047,0,0,208,4,208,4,malware,snakekeylogger
7261190514646026982,10.127.0.105,132.226.247.73,80,tcp,http,100671,485,5,427,6,912,11,malware,snakekeylogger
-482394972767675594,10.127.0.120,20.190.159.73,443,tcp,-,15031,0,0,260,5,260,5,malware,snakekeylogger
6498386692101730390,10.127.0.120,52.152.110.14,443,tcp,-,90331,0,0,1560,30,1560,30,malware,snakekeylogger
4191126794220441036,10.127.0.120,132.226.247.73,80,tcp,http,100677,485,5,427,6,912,11,malware,snakekeylogger
2826636575208760742,10.127.0.115,40.126.32.76,443,tcp,-,15031,0,0,260,5,260,5,malware,snakekeylogger
3112129768181686194,10.127.0.115,193.122.6.168,80,tcp,-,15044,0,0,260,5,260,5,malware,snakekeylogger
-438226592168726293,10.127.0.115,8.241.132.126,80,tcp,-,1,88,1,46,1,134,2,malware,snakekeylogger
4291035871306354633,10.127.0.115,132.226.8.169,80,tcp,-,15015,0,0,260,5,260,5,malware,snakekeylogger
-7170881326208728331,10.127.0.115,193.122.130.0,80,tcp,-,7000,0,0,208,4,208,4,malware,snakekeylogger
-7299238433690933536,10.127.0.78,8.238.178.254,80,tcp,-,185544,0,0,3158,68,3158,68,malware,snakekeylogger
-2230180367339078195,10.127.0.78,93.184.220.29,80,tcp,-,113677,0,0,1932,42,1932,42,malware,snakekeylogger
3227339599634783886,10.127.0.78,8.8.8.8,53,udp,dns,8649,8599,61,4706,66,13305,127,normal,-
-8882851677206133462,10.127.0.78,52.152.110.14,443,tcp,-,364588,0,0,6500,125,6500,125,malware,snakekeylogger
3266256031944011148,10.127.0.78,20.190.159.2,443,tcp,-,15046,0,0,260,5,260,5,malware,snakekeylogger
-6308440850278530683,10.127.0.78,173.223.113.164,443,tcp,-,75817,0,0,1288,28,1288,28,malware,snakekeylogger
-6791754192103054688,10.127.0.78,132.226.247.73,80,tcp,http,65446,445,4,381,5,826,9,malware,snakekeylogger
9145196278142604990,10.127.0.78,104.85.1.163,80,tcp,-,56862,0,0,966,21,966,21,malware,snakekeylogger
736974350378386086,10.127.0.78,204.79.197.203,80,tcp,-,75846,0,0,1288,28,1288,28,malware,snakekeylogger
7243149351980946446,10.127.0.17,132.226.8.169,80,tcp,http,101352,485,5,427,6,912,11,malware,snakekeylogger
-5230912116154547,10.127.0.175,52.152.110.14,443,tcp,-,82120,0,0,1508,29,1508,29,malware,snakekeylogger
-7689585093928331763,10.127.0.175,13.69.239.74,443,tcp,-,18953,0,0,322,7,322,7,malware,snakekeylogger
4948950360627961809,10.127.0.175,8.248.5.254,80,tcp,-,57006,0,0,966,21,966,21,malware,snakekeylogger
3357648777269428188,10.127.0.175,132.226.247.73,80,tcp,http,100720,485,5,427,6,912,11,malware,snakekeylogger
3884019917660542299,10.127.0.175,204.79.197.203,80,tcp,-,18952,0,0,322,7,322,7,malware,snakekeylogger
-6580942135317766889,10.127.0.201,8.8.8.8,53,udp,dns,2142,3688,39,2578,40,6266,79,normal,-
6549576106903379784,10.127.0.201,193.122.6.168,80,tcp,http,65018,758,5,387,5,1145,10,malware,snakekeylogger
7993776875042461512,10.127.0.111,158.101.44.242,80,tcp,http,101135,485,5,427,6,912,11,malware,snakekeylogger
-902040928009337153,10.127.0.121,209.197.3.8,80,tcp,-,188863,0,0,3232,67,3232,67,malware,snakekeylogger
6074068454223436312,10.127.0.121,52.152.110.14,443,tcp,-,246566,0,0,4524,87,4524,87,malware,snakekeylogger
28759635046551835,10.127.0.121,13.89.178.27,443,tcp,-,56856,0,0,966,21,966,21,malware,snakekeylogger
5680710475455634754,10.127.0.121,93.184.220.29,80,tcp,-,56859,0,0,966,21,966,21,malware,snakekeylogger
7054586031718727795,10.127.0.168,84.53.175.11,80,tcp,-,37922,0,0,644,14,644,14,malware,snakekeylogger
-1444972801978368502,10.127.0.168,132.226.247.73,80,tcp,-,15003,0,0,260,5,260,5,malware,snakekeylogger
7887238525828420900,10.127.0.168,158.101.44.242,80,tcp,-,15025,0,0,260,5,260,5,malware,snakekeylogger
-4248207357948246896,10.127.0.168,13.69.239.74,443,tcp,-,37948,0,0,644,14,644,14,malware,snakekeylogger
-4451256208158339928,10.127.0.168,193.122.130.0,80,tcp,-,15046,0,0,260,5,260,5,malware,snakekeylogger
5023477626316427293,10.127.0.168,173.223.113.131,80,tcp,-,94908,0,0,1610,35,1610,35,malware,snakekeylogger
4791951460903349508,10.127.0.168,132.226.8.169,80,tcp,-,15046,0,0,260,5,260,5,malware,snakekeylogger
7641428438624342929,10.127.0.168,193.122.6.168,80,tcp,-,15031,0,0,260,5,260,5,malware,snakekeylogger
-7690917443915566500,10.127.0.116,104.208.16.90,443,tcp,-,56857,0,0,966,21,966,21,malware,snakekeylogger
5524769920767560453,10.127.0.116,132.226.8.169,80,tcp,-,15076,0,0,260,5,260,5,malware,snakekeylogger
-7758183630749014382,10.127.0.116,132.226.247.73,80,tcp,-,15021,0,0,260,5,260,5,malware,snakekeylogger
7682277036780565808,10.127.0.116,193.122.130.0,80,tcp,-,15015,0,0,260,5,260,5,malware,snakekeylogger
1772004089681882546,10.127.0.116,193.122.6.168,80,tcp,-,15031,0,0,260,5,260,5,malware,snakekeylogger
-5966221053142316014,10.127.0.116,158.101.44.242,80,tcp,-,15046,0,0,260,5,260,5,malware,snakekeylogger
4502753472777318064,10.127.0.70,132.226.8.169,80,tcp,http,65563,758,5,433,6,1191,11,malware,snakekeylogger
2738433528327842240,10.127.0.78,193.122.6.168,80,tcp,http,67076,758,5,387,5,1145,10,malware,snakekeylogger
-616135674858332141,10.127.0.77,84.53.175.11,80,tcp,-,0,80,2,92,2,172,4,malware,snakekeylogger
-8486750460655049045,10.127.0.77,88.221.25.154,80,tcp,-,0,40,1,46,1,86,2,malware,snakekeylogger
6313403357364928213,10.127.0.77,132.226.247.73,80,tcp,http,74812,445,4,485,7,930,11,malware,snakekeylogger
-670312142213435611,10.127.0.53,93.184.220.29,80,tcp,-,30043,0,0,520,10,520,10,malware,dridex
-2140391578614239894,10.127.0.165,107.191.111.143,443,tcp,-,15026,0,0,260,5,260,5,malware,dridex
7136676526975978096,10.127.0.165,40.79.141.152,443,tcp,-,37906,0,0,644,14,644,14,malware,dridex
5386182345674522437,10.127.0.113,52.109.8.45,443,tcp,-,0,40,1,0,0,40,1,malware,dridex
5848093786772247873,10.127.0.168,20.42.73.26,443,tcp,-,56969,0,0,966,21,966,21,malware,dridex
3436146823863930320,10.127.0.168,52.152.110.14,443,tcp,-,262833,0,0,4628,89,4628,89,malware,dridex
-5390771222261101748,10.127.0.168,204.79.197.203,80,tcp,-,56969,0,0,966,21,966,21,malware,dridex
4463736298063872658,10.127.0.140,107.191.111.143,443,tcp,-,20400,0,0,304,6,304,6,malware,dridex
-5238780043395366767,10.127.0.117,195.123.213.19,443,tcp,-,15040,0,0,260,5,260,5,malware,dridex
-1034662139846289311,10.127.0.117,195.123.238.51,443,tcp,-,3012,0,0,156,3,156,3,malware,dridex
3664860160024821466,10.127.0.123,198.50.175.170,443,tcp,http,857,6274,11,1312,14,7586,25,malware,dridex
-6179412438639743035,10.127.0.123,198.57.247.155,443,tcp,tls,817,5305,8,641,10,5946,18,malware,dridex
6637920869388971975,10.127.0.123,162.241.5.72,443,tcp,http,1078,5878,10,1291,14,7169,24,malware,dridex
-6317422610218511066,10.127.0.187,8.8.8.8,53,udp,dns,3489,12761,87,6244,87,19005,174,normal,-
-1201564895671529241,10.127.0.187,162.159.135.233,443,tcp,http,1481,8371,18,1723,13,10094,31,malware,dridex
-5581089494214665527,10.127.0.187,209.197.3.8,80,tcp,-,259854,0,0,4496,92,4496,92,malware,dridex
-9200769719517060474,10.127.0.187,52.152.108.96,443,tcp,-,45084,0,0,780,15,780,15,malware,dridex
-1546126117030898130,10.127.0.187,20.189.173.4,443,tcp,-,62124,0,0,966,21,966,21,malware,dridex
7065710574251573338,10.127.0.187,173.223.113.164,443,tcp,-,75810,0,0,1288,28,1288,28,malware,dridex
-7205569965379974820,10.127.0.187,173.223.113.131,80,tcp,-,56875,0,0,966,21,966,21,malware,dridex
8367174009952138789,10.127.0.187,204.79.197.203,80,tcp,-,56858,0,0,966,21,966,21,malware,dridex
-4276149470841599238,10.127.0.69,135.125.238.108,14433,tcp,tls,58646,5443,12,1558,13,7001,25,malware,dridex
4875880342147382387,10.127.0.69,20.189.173.12,443,tcp,-,75999,0,0,1288,28,1288,28,malware,dridex
-2381645468551222550,10.127.0.69,8.238.20.126,80,tcp,-,154098,0,0,2576,56,2576,56,malware,dridex
8437712115232382411,10.127.0.69,131.253.33.203,80,tcp,-,76420,0,0,1288,28,1288,28,malware,dridex
-6077561164576856534,10.127.0.8,8.8.8.8,53,udp,dns,228,758,8,503,8,1261,16,normal,-
7607113454782777212,10.127.0.8,108.167.132.188,443,tcp,tls,1351,789,18,1258,19,2047,37,malware,dridex
-5792685176136202977,10.127.0.8,192.110.165.146,443,tcp,tls,1716,2135,20,1656,28,3791,48,malware,dridex
-5684686458389532682,10.127.0.74,188.165.45.228,443,tcp,-,2778,240,6,304,6,544,12,malware,dridex
-7781025814429180320,10.127.0.176,188.210.221.84,80,tcp,-,30739,1180,4,802,9,1982,13,malware,dridex
-5381976028242213721,10.127.0.176,107.154.175.173,443,tcp,tls,10648,4400,14,1258,16,5658,30,malware,dridex
4469613347889133144,10.127.0.176,8.26.21.168,443,tcp,tls,17795,53278,60,3975,65,57253,125,malware,dridex
-4990314379486990369,10.127.0.176,162.241.5.72,443,tcp,tls,3988,13423,57,5075,66,18498,123,malware,dridex
-5934298638699385257,10.127.0.176,198.57.247.155,443,tcp,tls,2771,6094,26,1871,29,7965,55,malware,dridex
-448884327165048184,10.127.0.176,192.254.225.15,443,tcp,tls,1837,789,18,1226,19,2015,37,malware,dridex
1189794007080873632,10.127.0.124,8.248.7.254,80,tcp,-,0,40,1,46,1,86,2,malware,dridex
-9012771607011579780,10.127.0.224,176.113.115.239,419,tcp,-,74185,2770,27,4336,20,7106,47,malware,dridex
-81224803955007745,10.127.0.224,176.113.115.135,419,tcp,-,67212,7226,79,100601,96,107827,175,malware,dridex
-546671821404521611,10.127.0.224,80.66.75.4,419,tcp,-,69917,19456,60,7948,42,27404,102,malware,dridex
-2557924369031878435,10.127.0.224,213.91.128.133,10060,tcp,-,30693,2227,7,650,7,2877,14,malware,dridex
-1339025008340352214,10.127.0.181,88.221.25.155,80,tcp,-,38477,0,0,644,14,644,14,malware,dridex
5700505744771762526,10.127.0.181,52.182.143.208,443,tcp,-,19334,0,0,322,7,322,7,malware,dridex
-2988659145522416338,10.127.0.108,198.50.175.170,443,tcp,tls,1677,749,17,1226,19,1975,36,malware,dridex
-1358404781422806819,10.127.0.108,198.57.247.155,443,tcp,tls,2015,789,18,1230,19,2019,37,malware,dridex
-6987815547103643425,10.127.0.108,162.241.5.72,443,tcp,tls,1451,789,18,1242,19,2031,37,malware,dridex
-3385380128350850665,10.127.0.108,75.119.223.218,443,tcp,http,6083,6920,13,1332,11,8252,24,malware,dridex
6591321649548386181,10.127.0.108,88.221.25.169,80,tcp,http,5273,1631,4,369,5,2000,9,malware,dridex
-716352843403412479,10.127.0.108,108.167.143.108,443,tcp,tls,2009,789,18,1230,19,2019,37,malware,dridex
-4966795349330958972,10.127.0.108,212.27.63.111,80,tcp,http,280,11755,12,889,10,12644,22,malware,dridex
6872967657853691748,10.127.0.108,160.153.129.227,443,tcp,tls,1053,5870,11,794,10,6664,21,malware,dridex
-1682199319212960104,10.127.0.108,192.254.225.15,443,tcp,tls,1996,789,18,1226,19,2015,37,malware,dridex
3433253104380302847,10.127.0.7,195.123.213.19,443,tcp,-,20291,0,0,304,6,304,6,malware,dridex
-1768676062749132166,10.127.0.120,20.42.73.24,443,tcp,-,18969,0,0,322,7,322,7,malware,dridex
-2328531354023301678,10.127.0.120,204.79.197.203,80,tcp,-,18953,0,0,322,7,322,7,malware,dridex
-4303997898781977740,10.127.0.120,88.221.25.155,80,tcp,-,18969,0,0,322,7,322,7,malware,dridex
-4368035758562223274,10.127.0.172,209.197.3.8,80,tcp,-,328842,0,0,5622,117,5622,117,malware,dridex
336306429565683376,10.127.0.172,108.167.132.188,443,tcp,-,21183,6513,15,1506,19,8019,34,malware,dridex
68262484596998654,10.127.0.172,192.110.165.146,443,tcp,-,63447,21684,27,2081,31,23765,58,malware,dridex
3407324615642704040,10.127.0.172,20.42.73.25,443,tcp,-,56874,0,0,966,21,966,21,malware,dridex
-409021485152051463,10.127.0.172,173.223.113.164,443,tcp,-,94795,0,0,1610,35,1610,35,malware,dridex
-4537992876842880175,10.127.0.172,173.223.113.131,80,tcp,-,94765,0,0,1610,35,1610,35,malware,dridex
-7411992975220318182,10.127.0.172,204.79.197.203,80,tcp,-,94764,0,0,1610,35,1610,35,malware,dridex
7676559859662651888,10.127.0.80,162.159.129.233,443,tcp,tls,306,438,10,640,10,1078,20,malware,dridex
-2072477427519504783,10.127.0.184,5.44.45.177,443,tcp,-,14996,0,0,260,5,260,5,malware,dridex
8242531780901480776,10.127.0.184,93.184.220.29,80,tcp,-,45118,0,0,780,15,780,15,malware,dridex
-1550355169296650345,10.127.0.121,188.165.45.228,443,tcp,-,2160,200,5,260,5,460,10,malware,dridex
-1379322459137566327,10.127.0.121,213.252.245.31,443,tcp,-,2299,200,5,260,5,460,10,malware,dridex
-6970272368595163834,10.127.0.201,192.254.225.15,443,tcp,tls,1735,789,18,1226,19,2015,37,malware,dridex
5178046694059000040,10.127.0.201,43.239.110.5,443,tcp,http,2631,6325,13,1461,10,7786,23,malware,dridex
-953807462927820020,10.127.0.201,162.241.5.72,443,tcp,tls,1130,789,18,1246,19,2035,37,malware,dridex
5827117594689831711,10.127.0.201,81.227.135.159,80,tcp,http,7861,557,3,703,6,1260,9,malware,dridex
7699867773749214982,10.127.0.201,188.210.221.84,80,tcp,http,3277,1140,3,643,5,1783,8,malware,dridex
7059308783773093494,10.127.0.201,188.210.221.84,443,tcp,http,5884,20305,28,2428,21,22733,49,malware,dridex
-1640342458509217454,10.127.0.201,198.143.186.143,443,tcp,tls,715,4754,9,727,9,5481,18,malware,dridex
-3090940274906051213,10.127.0.201,198.57.247.155,443,tcp,tls,1668,789,18,1230,19,2019,37,malware,dridex
-5499650102272104408,10.127.0.74,93.184.220.29,80,tcp,-,52930,0,0,904,19,904,19,malware,dridex
-5422484131160521554,10.127.0.74,8.238.179.126,80,tcp,-,90906,0,0,1548,33,1548,33,malware,dridex
-6660852688267528783,10.127.0.74,173.223.113.131,80,tcp,-,36985,0,0,552,12,552,12,malware,dridex
4513533904080216698,10.127.0.74,204.79.197.203,80,tcp,-,36985,0,0,552,12,552,12,malware,dridex
-7995333972494221303,10.127.0.168,20.190.159.23,443,tcp,-,15051,0,0,260,5,260,5,malware,dridex
-911671378263220408,10.127.0.168,35.190.80.1,443,tcp,tls,0,113,1,46,1,159,2,malware,dridex
2647331090715818046,10.127.0.67,209.197.3.8,80,tcp,-,177113,0,0,3046,61,3046,61,malware,dridex
-3759141612554899582,10.127.0.67,8.8.8.8,53,udp,dns,4346,14420,105,7323,105,21743,210,normal,-
-8649534571766347611,10.127.0.67,93.184.221.240,80,tcp,-,56842,0,0,966,21,966,21,malware,dridex
2675149347658611010,10.127.0.67,20.189.173.6,443,tcp,-,57099,0,0,966,21,966,21,malware,dridex
-8822752501794366794,10.127.0.67,173.223.113.164,443,tcp,-,114264,0,0,1932,42,1932,42,malware,dridex
-2763803237634615775,10.127.0.67,173.223.113.131,80,tcp,-,114269,0,0,1932,42,1932,42,malware,dridex
-1777337301137450025,10.127.0.67,204.79.197.203,80,tcp,-,56943,0,0,966,21,966,21,malware,dridex
-9180511367836433407,10.127.0.67,40.126.32.136,443,tcp,-,30076,0,0,520,10,520,10,malware,dridex
-2820111169037186215,10.127.0.181,93.184.220.29,80,tcp,-,83120,0,0,1424,29,1424,29,malware,dridex
1653093381509691879,10.127.0.181,93.184.221.240,80,tcp,-,75853,0,0,1288,28,1288,28,malware,dridex
-4644295694346241670,10.127.0.181,52.152.108.96,443,tcp,-,30297,0,0,520,10,520,10,malware,dridex
-2829071147853986900,10.127.0.181,20.189.173.3,443,tcp,-,41405,0,0,644,14,644,14,malware,dridex
8525290652138589465,10.127.0.181,204.79.197.203,80,tcp,-,38421,0,0,644,14,644,14,malware,dridex
-2445616951072064765,10.127.0.129,40.126.31.67,443,tcp,-,15045,0,0,260,5,260,5,malware,dridex
-6307540340735052709,10.127.0.129,192.254.225.15,443,tcp,http,1298,5911,11,1284,14,7195,25,malware,dridex
7172996536742565739,10.127.0.129,43.239.110.5,443,tcp,http,1127,6641,12,1333,14,7974,26,malware,dridex
4950101775002068025,10.127.0.129,162.241.5.72,443,tcp,http,632,5967,11,1296,14,7263,25,malware,dridex
-5383499426266377286,10.127.0.129,81.227.135.159,80,tcp,http,3652,517,2,618,5,1135,7,malware,dridex
-3510749247206994015,10.127.0.129,188.210.221.84,80,tcp,http,3009,1140,3,604,5,1744,8,malware,dridex
8564860638718613411,10.127.0.129,188.210.221.84,443,tcp,http,5301,19920,27,2862,33,22782,60,malware,dridex
2882855604225497428,10.127.0.129,198.143.186.143,443,tcp,tls,646,4489,7,599,9,5088,16,malware,dridex
2764475602652118243,10.127.0.129,198.57.247.155,443,tcp,tls,751,5305,8,641,10,5946,18,malware,dridex
-6218650623162753125,10.127.0.129,52.152.110.14,443,tcp,-,90155,0,0,1560,30,1560,30,malware,dridex
5984827628258429683,10.127.0.129,20.42.73.27,443,tcp,-,18952,0,0,322,7,322,7,malware,dridex
-3500343347709294908,10.127.0.129,8.248.3.254,80,tcp,-,37907,0,0,644,14,644,14,malware,dridex
5244820508945799618,10.127.0.167,93.184.220.29,80,tcp,-,15019,0,0,260,5,260,5,malware,dridex
3532445201104609741,10.127.0.167,192.52.166.96,443,tcp,http,1986,2641,11,5197,17,7838,28,malware,dridex
4738239023117904426,10.127.0.167,20.42.65.88,443,tcp,-,56888,0,0,966,21,966,21,malware,dridex
-1892140359195957991,10.127.0.167,20.54.89.15,443,tcp,-,45061,0,0,780,15,780,15,malware,dridex
2671995770857820887,10.127.0.167,93.184.221.240,80,tcp,-,558750,80,2,9736,202,9816,204,malware,dridex
4752237873050255533,10.127.0.167,173.223.113.164,443,tcp,-,170621,0,0,2898,63,2898,63,malware,dridex
-5490659585735630765,10.127.0.167,173.223.113.131,80,tcp,-,284360,0,0,4830,105,4830,105,malware,dridex
-4504193649238465015,10.127.0.167,204.79.197.203,80,tcp,-,170621,0,0,2898,63,2898,63,malware,dridex
3987071685847398353,10.127.0.76,209.197.3.8,80,tcp,-,83248,0,0,1424,29,1424,29,malware,dridex
-3487523580229613913,10.127.0.76,20.189.173.3,443,tcp,-,19453,0,0,322,7,322,7,malware,dridex
-9088116161528803107,10.127.0.10,185.206.146.88,443,tcp,-,12848,44,1,374,8,418,9,malware,dridex
-2088841333743398566,10.127.0.163,8.248.7.254,80,tcp,-,1,40,1,46,1,86,2,malware,dridex
-6380945942668532513,10.127.0.189,185.206.146.88,443,tcp,-,9847,44,1,374,8,418,9,malware,dridex
1589860471034425509,10.127.0.184,52.152.110.14,443,tcp,-,0,0,0,104,2,104,2,malware,dridex
2956778052794874308,10.127.0.184,93.184.221.240,80,tcp,-,52926,0,0,904,19,904,19,malware,dridex
815921944746924661,10.127.0.184,13.69.239.72,443,tcp,-,37906,0,0,644,14,644,14,malware,dridex
-2807945812983349308,10.127.0.184,173.223.113.164,443,tcp,-,37903,0,0,644,14,644,14,malware,dridex
-4363057476713168552,10.127.0.184,173.223.113.131,80,tcp,-,37922,0,0,644,14,644,14,malware,dridex
-8626713223917634434,10.127.0.184,131.253.33.203,80,tcp,-,37906,0,0,644,14,644,14,malware,dridex
4689799408108469455,10.127.0.183,209.197.3.8,80,tcp,-,484409,0,0,8272,172,8272,172,malware,dridex
8698691083612431894,10.127.0.183,93.184.220.29,80,tcp,-,170105,0,0,2910,60,2910,60,malware,dridex
-4184430528333700866,10.127.0.183,206.217.143.91,443,tcp,tls,952,6408,13,999,10,7407,23,malware,dridex
9153029661915222256,10.127.0.183,13.89.178.26,443,tcp,-,95139,0,0,1610,35,1610,35,malware,dridex
-4023227421420933680,10.127.0.176,188.210.221.84,443,tcp,http,39848,20141,31,3046,37,23187,68,malware,dridex
1371123771745490202,10.127.0.173,52.109.13.63,443,tcp,-,0,40,1,0,0,40,1,malware,dridex
-8238518101086778107,10.127.0.28,5.44.45.177,443,tcp,http,952,1790,10,8768,14,10558,24,malware,dridex
-1107766844560574569,10.127.0.16,192.52.166.96,443,tcp,http,1576,2346,13,9046,16,11392,29,malware,dridex
4512116916965744839,10.127.0.128,13.107.4.50,80,tcp,-,113877,0,0,1932,42,1932,42,malware,dridex
-1479243086912159206,10.127.0.128,52.152.110.14,443,tcp,-,165657,0,0,3016,58,3016,58,malware,dridex
-842197907782266481,10.127.0.128,13.69.109.131,443,tcp,-,37905,0,0,644,14,644,14,malware,dridex
5173428222954896061,10.127.0.128,93.184.220.29,80,tcp,-,38234,0,0,644,14,644,14,malware,dridex
-8913373119161249783,10.127.0.107,8.238.179.126,80,tcp,-,386926,0,0,6576,141,6576,141,malware,dridex
837556987783795455,10.127.0.107,52.182.141.63,443,tcp,-,114095,0,0,1932,42,1932,42,malware,dridex
4158197855281338314,10.127.0.167,192.229.232.200,443,tcp,http,110082,9403,19,1777,21,11180,40,malware,avaddon
6047411775417090862,10.127.0.167,40.125.122.176,443,tcp,http,105937,5680,8,1093,13,6773,21,malware,avaddon
4322724396886567053,10.127.0.167,52.152.110.14,443,tcp,-,526045,0,0,9360,180,9360,180,malware,avaddon
52314489021098911,10.127.0.167,84.53.175.11,80,tcp,http,83777,68944,63,3891,65,72835,128,malware,avaddon
1706547833612139843,10.127.0.167,172.64.204.35,443,tcp,http,83362,4234,10,946,13,5180,23,malware,avaddon
8602385581929930407,10.127.0.167,10.127.0.1,445,tcp,-,15151,0,0,260,5,260,5,malware,avaddon
-249529384451386551,10.127.0.167,10.127.0.1,139,tcp,-,15170,0,0,260,5,260,5,malware,avaddon
6032294098450762605,10.127.0.167,52.168.112.67,443,tcp,-,113942,0,0,1932,42,1932,42,malware,avaddon
7380054285582835506,10.127.0.167,10.127.0.2,445,tcp,-,15011,0,0,260,5,260,5,malware,avaddon
5574168607836375373,10.127.0.167,10.127.0.2,139,tcp,-,15045,0,0,260,5,260,5,malware,avaddon
-7205712738292709095,10.127.0.167,10.127.0.3,445,tcp,-,15043,0,0,260,5,260,5,malware,avaddon
-9011598416039169228,10.127.0.167,10.127.0.3,139,tcp,-,15047,0,0,260,5,260,5,malware,avaddon
-1085987994280927421,10.127.0.167,10.127.0.4,445,tcp,-,15011,0,0,260,5,260,5,malware,avaddon
7666021285961898445,10.127.0.167,10.127.0.4,139,tcp,-,15061,0,0,260,5,260,5,malware,avaddon
6108270603487862426,10.127.0.167,10.127.0.5,445,tcp,-,3012,0,0,156,3,156,3,malware,avaddon
3415893212111463339,10.127.0.167,10.127.0.5,139,tcp,-,3029,0,0,156,3,156,3,malware,avaddon
-7398789901620817104,10.127.0.190,217.8.117.63,80,tcp,-,30018,0,0,520,10,520,10,malware,avaddon
6624161835337171178,10.127.0.190,52.178.17.2,443,tcp,-,56873,0,0,966,21,966,21,malware,avaddon
3638348602469231966,10.127.0.190,8.248.3.254,80,tcp,-,170577,0,0,2898,63,2898,63,malware,avaddon
-1634360030845808508,10.127.0.190,40.126.17.134,443,tcp,-,15046,0,0,260,5,260,5,malware,avaddon
-8004125976104783843,10.127.0.190,20.190.145.160,443,tcp,-,15000,0,0,260,5,260,5,malware,avaddon
-8876214728838279262,10.127.0.180,10.127.0.1,445,tcp,-,15001,0,0,260,5,260,5,malware,avaddon
718614378489955396,10.127.0.180,10.127.0.1,139,tcp,-,14999,0,0,260,5,260,5,malware,avaddon
-5271226265003910866,10.127.0.180,10.127.0.2,445,tcp,-,15027,0,0,260,5,260,5,malware,avaddon
-7077111942750370999,10.127.0.180,10.127.0.2,139,tcp,-,15077,0,0,260,5,260,5,malware,avaddon
-7080388802436775940,10.127.0.180,10.127.0.3,445,tcp,-,15042,0,0,260,5,260,5,malware,avaddon
2514440304891458718,10.127.0.180,10.127.0.3,139,tcp,-,15108,0,0,260,5,260,5,malware,avaddon
-960664058424994266,10.127.0.180,10.127.0.4,445,tcp,-,15028,0,0,260,5,260,5,malware,avaddon
8634165048903240392,10.127.0.180,10.127.0.4,139,tcp,-,15015,0,0,260,5,260,5,malware,avaddon
7505376743626299542,10.127.0.180,10.127.0.5,445,tcp,-,15011,0,0,260,5,260,5,malware,avaddon
3051819160229350712,10.127.0.180,10.127.0.5,139,tcp,-,7044,0,0,208,4,208,4,malware,avaddon
-9043467890526219674,10.127.0.177,172.64.204.35,443,tcp,http,29815,3314,8,739,8,4053,16,malware,avaddon
-8563686047178186863,10.127.0.163,172.64.204.35,443,tcp,http,111728,4671,11,837,10,5508,21,malware,avaddon
7479444487340425123,10.127.0.19,8.8.8.8,53,udp,dns,297,1083,7,465,7,1548,14,normal,-
4795767901576705495,10.127.0.19,192.229.232.200,443,tcp,http,114428,9850,20,1661,16,11511,36,malware,avaddon
-7363404869012725445,10.127.0.19,40.125.122.176,443,tcp,http,109997,5722,8,940,9,6662,17,malware,avaddon
-6185307354263718158,10.127.0.19,173.223.113.131,80,tcp,http,62800,2798,4,415,5,3213,9,normal,-
-6665558102953857460,10.127.0.19,8.241.137.254,80,tcp,http,109065,72144,134,6099,113,78243,247,malware,avaddon
5040283145929714310,10.127.0.19,172.64.204.35,443,tcp,http,107024,4082,10,779,9,4861,19,malware,avaddon
7428924522182611681,10.127.0.82,217.8.117.63,80,tcp,-,3061,240,6,304,6,544,12,malware,avaddon
8309391329130240596,10.127.0.105,217.8.117.63,80,tcp,-,17338,200,5,520,10,720,15,malware,avaddon
-6866857577032347230,10.127.0.105,20.190.160.14,443,tcp,-,15046,0,0,260,5,260,5,malware,avaddon
7286845631710198505,10.127.0.168,10.127.0.1,445,tcp,-,15066,0,0,260,5,260,5,malware,avaddon
-1565069334671118453,10.127.0.168,10.127.0.1,139,tcp,-,15091,0,0,260,5,260,5,malware,avaddon
6493476712560198773,10.127.0.168,10.127.0.2,445,tcp,-,15017,0,0,260,5,260,5,malware,avaddon
4687591034813738640,10.127.0.168,10.127.0.2,139,tcp,-,15013,0,0,260,5,260,5,malware,avaddon
-2361715113507523126,10.127.0.168,10.127.0.3,445,tcp,-,15026,0,0,260,5,260,5,malware,avaddon
-4167600791253983259,10.127.0.168,10.127.0.3,139,tcp,-,15044,0,0,260,5,260,5,malware,avaddon
1184149902543249080,10.127.0.168,10.127.0.4,445,tcp,-,15027,0,0,260,5,260,5,malware,avaddon
-621735775203211053,10.127.0.168,10.127.0.4,139,tcp,-,15044,0,0,260,5,260,5,malware,avaddon
-8796553369115008728,10.127.0.168,10.127.0.5,445,tcp,-,15042,0,0,260,5,260,5,malware,avaddon
-44544088872182862,10.127.0.168,10.127.0.5,139,tcp,-,15044,0,0,260,5,260,5,malware,avaddon
1777717311042242427,10.127.0.187,217.8.117.63,80,tcp,-,4256,240,6,304,6,544,12,malware,avaddon
-1793573337461785216,10.127.0.78,52.183.220.149,443,tcp,-,-1,0,0,0,0,0,0,malware,avaddon
2910625382828508790,10.127.0.78,154.61.71.12,443,tcp,tls,1,88,1,46,1,134,2,malware,avaddon
-7550361709104405703,10.127.0.78,20.190.159.0,443,tcp,-,30060,0,0,520,10,520,10,malware,avaddon
-54641568861335719,10.127.0.78,172.64.204.35,443,tcp,tls,32814,3156,8,940,14,4096,22,malware,avaddon
7634128874824298477,10.127.0.78,20.190.159.4,443,tcp,-,15046,0,0,260,5,260,5,malware,avaddon
4398807257286322481,10.127.0.78,172.64.205.35,443,tcp,http,70971,4072,9,851,12,4923,21,malware,avaddon
-2014506661570670312,10.127.0.78,10.127.0.1,445,tcp,-,14997,0,0,260,5,260,5,malware,avaddon
7580322445757564346,10.127.0.78,10.127.0.1,139,tcp,-,15029,0,0,260,5,260,5,malware,avaddon
5618864883109359944,10.127.0.78,10.127.0.2,445,tcp,-,15027,0,0,260,5,260,5,malware,avaddon
-3233050083271957014,10.127.0.78,10.127.0.2,139,tcp,-,15045,0,0,260,5,260,5,malware,avaddon
-8966902140766184657,10.127.0.78,10.127.0.3,445,tcp,-,15026,0,0,260,5,260,5,malware,avaddon
6358502164369872703,10.127.0.78,10.127.0.3,139,tcp,-,15044,0,0,260,5,260,5,malware,avaddon
2883397801053419719,10.127.0.78,10.127.0.4,445,tcp,-,1012,0,0,104,2,104,2,malware,avaddon
-5968517165327897239,10.127.0.78,10.127.0.4,139,tcp,-,1013,0,0,104,2,104,2,malware,avaddon
3813763311324541114,10.127.0.59,8.8.8.8,53,udp,dns,1268,5976,42,2976,42,8952,84,normal,-
1773236029111400498,10.127.0.59,52.152.108.96,443,tcp,-,29991,0,0,520,10,520,10,malware,avaddon
-4366042024239689117,10.127.0.59,209.197.3.8,80,tcp,-,37905,0,0,644,14,644,14,malware,avaddon
-4900320609214067717,10.127.0.59,8.238.177.126,80,tcp,-,37904,0,0,644,14,644,14,malware,avaddon
2610618456959677659,10.127.0.59,173.223.113.164,443,tcp,-,56855,0,0,966,21,966,21,malware,avaddon
6021895815468939981,10.127.0.59,173.223.113.131,80,tcp,-,37905,0,0,644,14,644,14,malware,avaddon
-7409999240897784025,10.127.0.59,204.79.197.203,80,tcp,-,37935,0,0,644,14,644,14,malware,avaddon
4398676852405404478,10.127.0.185,172.64.204.35,443,tcp,http,114683,4674,11,837,10,5511,21,malware,avaddon
665012836772559049,10.127.0.189,192.229.232.200,443,tcp,http,109581,9407,19,1777,21,11184,40,malware,avaddon
-6652012479075836797,10.127.0.189,40.127.169.103,443,tcp,http,106405,5680,8,1093,13,6773,21,malware,avaddon
7161032918213501928,10.127.0.189,8.241.137.254,80,tcp,http,106300,72144,134,7249,138,79393,272,malware,avaddon
4030759092449771490,10.127.0.189,172.64.205.35,443,tcp,http,104343,4230,10,946,13,5176,23,malware,avaddon
-1050337011583766729,10.127.0.189,10.127.0.1,445,tcp,-,15004,0,0,260,5,260,5,malware,avaddon
8544492095744467929,10.127.0.189,10.127.0.1,139,tcp,-,15059,0,0,260,5,260,5,malware,avaddon
6583034533096263527,10.127.0.189,10.127.0.2,445,tcp,-,15057,0,0,260,5,260,5,malware,avaddon
-2268880433285053431,10.127.0.189,10.127.0.2,139,tcp,-,15030,0,0,260,5,260,5,malware,avaddon
6415628502084608682,10.127.0.189,10.127.0.3,445,tcp,-,15027,0,0,260,5,260,5,malware,avaddon
4609742824338148549,10.127.0.189,10.127.0.3,139,tcp,-,15030,0,0,260,5,260,5,malware,avaddon
-1883007746767499400,10.127.0.189,10.127.0.4,445,tcp,-,15059,0,0,260,5,260,5,malware,avaddon
7711821360560735258,10.127.0.189,10.127.0.4,139,tcp,-,15026,0,0,260,5,260,5,malware,avaddon
5711365444284945782,10.127.0.189,10.127.0.5,445,tcp,-,15043,0,0,260,5,260,5,malware,avaddon
3905479766538485649,10.127.0.189,10.127.0.5,139,tcp,-,15029,0,0,260,5,260,5,malware,avaddon
7928455061859889001,10.127.0.192,8.8.8.8,53,udp,dns,4585,6470,55,3888,55,10358,110,normal,-
112749072693425335,10.127.0.192,10.127.0.1,445,tcp,-,15115,0,0,260,5,260,5,malware,avaddon
-8739165893687891623,10.127.0.192,10.127.0.1,139,tcp,-,15015,0,0,260,5,260,5,malware,avaddon
7746120617373455591,10.127.0.192,10.127.0.2,445,tcp,-,15029,0,0,260,5,260,5,malware,avaddon
-1105794349007861367,10.127.0.192,10.127.0.2,139,tcp,-,15060,0,0,260,5,260,5,malware,avaddon
-2174331680796939037,10.127.0.192,51.11.192.49,443,tcp,-,37905,0,0,644,14,644,14,malware,avaddon
-9093106438722542839,10.127.0.192,10.127.0.3,445,tcp,-,15042,0,0,260,5,260,5,malware,avaddon
-7387126447114573798,10.127.0.192,10.127.0.3,139,tcp,-,15045,0,0,260,5,260,5,malware,avaddon
-6240855965026591771,10.127.0.192,117.18.232.240,80,tcp,-,402151,0,0,2576,56,2576,56,malware,avaddon
-4181185116014435036,10.127.0.192,173.223.113.164,443,tcp,-,56857,0,0,966,21,966,21,malware,avaddon
612296152333147238,10.127.0.192,10.127.0.4,445,tcp,-,15060,0,0,260,5,260,5,malware,avaddon
-3841261431063801592,10.127.0.192,10.127.0.4,139,tcp,-,15029,0,0,260,5,260,5,malware,avaddon
-8998432817186404302,10.127.0.192,10.127.0.5,445,tcp,-,15027,0,0,260,5,260,5,malware,avaddon
7642425578776687181,10.127.0.192,10.127.0.5,139,tcp,-,15029,0,0,260,5,260,5,malware,avaddon
-4796815854689251168,10.127.0.192,10.127.0.6,445,tcp,-,7027,0,0,208,4,208,4,malware,avaddon
-6602701532435711301,10.127.0.192,10.127.0.6,139,tcp,-,3030,0,0,156,3,156,3,malware,avaddon
-8893596809310434388,10.127.0.193,10.127.0.1,445,tcp,-,15002,0,0,260,5,260,5,malware,avaddon
5772368362954932403,10.127.0.193,209.197.3.8,80,tcp,-,113724,0,0,1932,42,1932,42,malware,avaddon
7747261586652657095,10.127.0.193,10.127.0.1,139,tcp,-,15203,0,0,260,5,260,5,malware,avaddon
-7915808832598702761,10.127.0.193,52.152.108.96,443,tcp,-,45046,0,0,780,15,780,15,malware,avaddon
1757420943158790833,10.127.0.193,10.127.0.2,445,tcp,-,15042,0,0,260,5,260,5,malware,avaddon
-48464734587669300,10.127.0.193,10.127.0.2,139,tcp,-,15030,0,0,260,5,260,5,malware,avaddon
8622747424814029825,10.127.0.193,20.42.65.90,443,tcp,-,56859,0,0,966,21,966,21,malware,avaddon
6950615807816252422,10.127.0.193,10.127.0.3,445,tcp,-,15013,0,0,260,5,260,5,malware,avaddon
5144730130069792289,10.127.0.193,10.127.0.3,139,tcp,-,15014,0,0,260,5,260,5,malware,avaddon
-7950263249842526988,10.127.0.193,10.127.0.4,445,tcp,-,15044,0,0,260,5,260,5,malware,avaddon
8690595146120564495,10.127.0.193,10.127.0.4,139,tcp,-,15029,0,0,260,5,260,5,malware,avaddon
4914134935193134948,10.127.0.193,10.127.0.5,445,tcp,-,15027,0,0,260,5,260,5,malware,avaddon
-4780599858273590802,10.127.0.193,10.127.0.5,139,tcp,-,15060,0,0,260,5,260,5,malware,avaddon
-4503672415837800237,10.127.0.193,10.127.0.6,445,tcp,-,7026,0,0,208,4,208,4,malware,avaddon
5091156691490434421,10.127.0.193,10.127.0.6,139,tcp,-,7045,0,0,208,4,208,4,malware,avaddon
-4137927802358419653,10.127.0.137,8.8.8.8,53,udp,dns,12,90,1,58,1,148,2,normal,-
-7419908970854539258,10.127.0.137,172.64.204.35,443,tcp,http,114587,4658,11,837,10,5495,21,malware,avaddon
1164021163123632518,10.127.0.122,10.127.0.1,445,tcp,-,15025,0,0,260,5,260,5,malware,avaddon
-7687893803257684440,10.127.0.122,10.127.0.1,139,tcp,-,15043,0,0,260,5,260,5,malware,avaddon
-58310133223462383,10.127.0.122,10.127.0.2,445,tcp,-,15044,0,0,260,5,260,5,malware,avaddon
-1864195810969922516,10.127.0.122,10.127.0.2,139,tcp,-,15013,0,0,260,5,260,5,malware,avaddon
3802666916610544632,10.127.0.122,10.127.0.3,445,tcp,-,15011,0,0,260,5,260,5,malware,avaddon
-5892067876856181118,10.127.0.122,10.127.0.3,139,tcp,-,15044,0,0,260,5,260,5,malware,avaddon
-4938674566043316907,10.127.0.122,10.127.0.4,445,tcp,-,15042,0,0,260,5,260,5,malware,avaddon
-6744560243789777040,10.127.0.122,10.127.0.4,139,tcp,-,15045,0,0,260,5,260,5,malware,avaddon
7925723618992345029,10.127.0.122,10.127.0.5,445,tcp,-,15011,0,0,260,5,260,5,malware,avaddon
6119837941245884896,10.127.0.122,10.127.0.5,139,tcp,-,15059,0,0,260,5,260,5,malware,avaddon
-3745543764259043985,10.127.0.122,10.127.0.6,445,tcp,-,3010,0,0,156,3,156,3,malware,avaddon
-5551429442005504118,10.127.0.122,10.127.0.6,139,tcp,-,3013,0,0,156,3,156,3,malware,avaddon
-1310393254040996165,10.127.0.66,10.127.0.1,445,tcp,-,15111,0,0,260,5,260,5,malware,avaddon
-3116278931787456298,10.127.0.66,10.127.0.1,139,tcp,-,15033,0,0,260,5,260,5,malware,avaddon
-7773901760457867986,10.127.0.66,10.127.0.2,445,tcp,-,15041,0,0,260,5,260,5,malware,avaddon
1820927346870366672,10.127.0.66,10.127.0.2,139,tcp,-,15061,0,0,260,5,260,5,malware,avaddon
-1339064982662851503,10.127.0.66,10.127.0.3,445,tcp,-,15027,0,0,260,5,260,5,malware,avaddon
8255764124665383155,10.127.0.66,10.127.0.3,139,tcp,-,15029,0,0,260,5,260,5,malware,avaddon
2206800033387920703,10.127.0.66,10.127.0.4,445,tcp,-,15011,0,0,260,5,260,5,malware,avaddon
-6645114932993396255,10.127.0.66,10.127.0.4,139,tcp,-,15030,0,0,260,5,260,5,malware,avaddon
2355029342521853725,10.127.0.66,10.127.0.5,445,tcp,-,15059,0,0,260,5,260,5,malware,avaddon
549143664775393592,10.127.0.66,10.127.0.5,139,tcp,-,15029,0,0,260,5,260,5,malware,avaddon
-6219958181423672668,10.127.0.66,10.127.0.6,445,tcp,-,7027,0,0,208,4,208,4,malware,avaddon
-1866306284165214930,10.127.0.66,10.127.0.6,139,tcp,-,7014,0,0,208,4,208,4,malware,avaddon
7960928024686339263,10.127.0.144,8.8.8.8,53,udp,dns,58,960,5,344,5,1304,10,normal,-
-6966283173237483948,10.127.0.144,192.229.232.200,443,tcp,http,114890,9850,20,1569,14,11419,34,malware,avaddon
-8552733291278057092,10.127.0.144,40.127.169.103,443,tcp,http,111132,5722,8,940,9,6662,17,malware,avaddon
1342205471717052807,10.127.0.144,173.223.113.131,80,tcp,http,62657,2798,4,415,5,3213,9,normal,-
4792217189590897947,10.127.0.144,117.18.232.240,80,tcp,http,111131,69097,67,2879,43,71976,110,malware,avaddon
-2268319102736816933,10.127.0.144,172.64.205.35,443,tcp,http,108949,4084,10,779,9,4863,19,malware,avaddon
4750746507288166923,10.127.0.80,10.127.0.1,445,tcp,-,15326,0,0,260,5,260,5,malware,avaddon
2944860829541706790,10.127.0.80,10.127.0.1,139,tcp,-,15215,0,0,260,5,260,5,malware,avaddon
-8890948277856534549,10.127.0.80,117.18.237.29,80,tcp,-,201698,0,0,1288,28,1288,28,malware,avaddon
-6062626021741354437,10.127.0.80,10.127.0.2,445,tcp,-,15018,0,0,260,5,260,5,malware,avaddon
-7531687321348649957,10.127.0.80,20.189.173.1,443,tcp,-,75808,0,0,1288,28,1288,28,malware,avaddon
-7868511699487814570,10.127.0.80,10.127.0.2,139,tcp,-,15060,0,0,260,5,260,5,malware,avaddon
7438046422959930161,10.127.0.80,8.238.177.126,80,tcp,-,151887,0,0,2576,56,2576,56,malware,avaddon
-2201648971907347422,10.127.0.80,10.127.0.3,445,tcp,-,15025,0,0,260,5,260,5,malware,avaddon
1723040548154015147,10.127.0.80,10.127.0.3,139,tcp,-,15026,0,0,260,5,260,5,malware,avaddon
1344216044143424784,10.127.0.80,10.127.0.4,445,tcp,-,14997,0,0,260,5,260,5,malware,avaddon
-7507698922237892174,10.127.0.80,10.127.0.4,139,tcp,-,15061,0,0,260,5,260,5,malware,avaddon
111734178082184643,10.127.0.80,10.127.0.5,445,tcp,-,15028,0,0,260,5,260,5,malware,avaddon
-8740180788299132315,10.127.0.80,10.127.0.5,139,tcp,-,15045,0,0,260,5,260,5,malware,avaddon
-2732678148055519048,10.127.0.80,10.127.0.6,445,tcp,-,3035,0,0,156,3,156,3,malware,avaddon
6019331132187306818,10.127.0.80,10.127.0.6,139,tcp,-,3013,0,0,156,3,156,3,malware,avaddon
-3642924672341872509,10.127.0.61,93.184.221.240,80,tcp,-,106043,0,0,1808,38,1808,38,malware,avaddon
8860860163623468505,10.127.0.61,10.127.0.1,445,tcp,-,15059,0,0,260,5,260,5,malware,avaddon
7054974485877008372,10.127.0.61,10.127.0.1,139,tcp,-,15109,0,0,260,5,260,5,malware,avaddon
-6390553429297494471,10.127.0.61,52.152.110.14,443,tcp,-,180402,0,0,3172,61,3172,61,malware,avaddon
1065133842383142110,10.127.0.61,10.127.0.2,445,tcp,-,15027,0,0,260,5,260,5,malware,avaddon
-7786781123998174848,10.127.0.61,10.127.0.2,139,tcp,-,15061,0,0,260,5,260,5,malware,avaddon
-7249835965150162780,10.127.0.61,104.208.16.90,443,tcp,-,37905,0,0,644,14,644,14,malware,avaddon
4926110892217149125,10.127.0.61,10.127.0.3,445,tcp,-,15027,0,0,260,5,260,5,malware,avaddon
-3925804074164167833,10.127.0.61,10.127.0.3,139,tcp,-,15029,0,0,260,5,260,5,malware,avaddon
-6390002330330901160,10.127.0.61,173.223.113.164,443,tcp,-,37905,0,0,644,14,644,14,malware,avaddon
7483983871859636247,10.127.0.61,173.223.113.131,80,tcp,-,37906,0,0,644,14,644,14,malware,avaddon
-3816756690347831748,10.127.0.61,204.79.197.203,80,tcp,-,37906,0,0,644,14,644,14,malware,avaddon
-6068690622657166243,10.127.0.61,10.127.0.4,445,tcp,-,15027,0,0,260,5,260,5,malware,avaddon
-3476218917419258248,10.127.0.61,10.127.0.4,139,tcp,-,15045,0,0,260,5,260,5,malware,avaddon
6795707562378495693,10.127.0.61,10.127.0.5,445,tcp,-,15060,0,0,260,5,260,5,malware,avaddon
4989821884632035560,10.127.0.61,10.127.0.5,139,tcp,-,15030,0,0,260,5,260,5,malware,avaddon
-1779279961567030700,10.127.0.61,10.127.0.6,445,tcp,-,7011,0,0,208,4,208,4,malware,avaddon
813191743670877295,10.127.0.61,10.127.0.6,139,tcp,-,7030,0,0,208,4,208,4,malware,avaddon
5666276819756783165,10.127.0.51,217.8.117.63,80,tcp,-,4447,400,10,520,10,920,20,malware,avaddon
-4881475783585076294,10.127.0.173,172.64.204.35,443,tcp,http,107743,4063,9,900,12,4963,21,malware,avaddon
-559497763228295198,10.127.0.173,10.127.0.1,445,tcp,-,15043,0,0,260,5,260,5,malware,avaddon
-5013055346625244028,10.127.0.173,10.127.0.1,139,tcp,-,15015,0,0,260,5,260,5,malware,avaddon
3045490700606073198,10.127.0.173,10.127.0.2,445,tcp,-,15027,0,0,260,5,260,5,malware,avaddon
6970180220667435767,10.127.0.173,10.127.0.2,139,tcp,-,15043,0,0,260,5,260,5,malware,avaddon
3810187891134217592,10.127.0.173,10.127.0.3,445,tcp,-,15058,0,0,260,5,260,5,malware,avaddon
-5041727075247099366,10.127.0.173,10.127.0.3,139,tcp,-,15050,0,0,260,5,260,5,malware,avaddon
7356052907184989798,10.127.0.173,10.127.0.4,445,tcp,-,15042,0,0,260,5,260,5,malware,avaddon
-1495862059196327160,10.127.0.173,10.127.0.4,139,tcp,-,15045,0,0,260,5,260,5,malware,avaddon
-922458247511107168,10.127.0.173,10.127.0.5,445,tcp,-,7011,0,0,208,4,208,4,malware,avaddon
-2728343925257567301,10.127.0.173,10.127.0.5,139,tcp,-,7029,0,0,208,4,208,4,malware,avaddon
8718779873727321553,10.127.0.102,172.64.205.35,443,tcp,-,15016,0,0,260,5,260,5,malware,avaddon
-1942699887796973107,10.127.0.102,172.64.204.35,443,tcp,http,87282,4065,9,900,12,4965,21,malware,avaddon
3637683769693783334,10.127.0.102,10.127.0.1,445,tcp,-,15027,0,0,260,5,260,5,malware,avaddon
6230155474931691329,10.127.0.102,10.127.0.1,139,tcp,-,15045,0,0,260,5,260,5,malware,avaddon
8129163947158090684,10.127.0.102,10.127.0.2,445,tcp,-,15023,0,0,260,5,260,5,malware,avaddon
-722751019223226274,10.127.0.102,10.127.0.2,139,tcp,-,15029,0,0,260,5,260,5,malware,avaddon
7591783614007729571,10.127.0.102,10.127.0.3,445,tcp,-,15042,0,0,260,5,260,5,malware,avaddon
3138226030610780741,10.127.0.102,10.127.0.3,139,tcp,-,15029,0,0,260,5,260,5,malware,avaddon
995339482117782331,10.127.0.102,10.127.0.4,445,tcp,-,15058,0,0,260,5,260,5,malware,avaddon
-8699395311348943419,10.127.0.102,10.127.0.4,139,tcp,-,15030,0,0,260,5,260,5,malware,avaddon
-1569360198766912384,10.127.0.102,10.127.0.5,445,tcp,-,3011,0,0,156,3,156,3,malware,avaddon
8025468908561322274,10.127.0.102,10.127.0.5,139,tcp,-,3014,0,0,156,3,156,3,malware,avaddon
5407563913032036438,10.127.0.220,217.8.117.63,80,tcp,-,3519,240,6,304,6,544,12,malware,avaddon
-9062031227375274734,10.127.0.54,10.127.0.1,445,tcp,-,15143,0,0,260,5,260,5,malware,avaddon
7578827168587816749,10.127.0.54,10.127.0.1,139,tcp,-,15046,0,0,260,5,260,5,malware,avaddon
-2809370857890417641,10.127.0.54,10.127.0.2,445,tcp,-,15055,0,0,260,5,260,5,malware,avaddon
6785458249437817017,10.127.0.54,10.127.0.2,139,tcp,-,15013,0,0,260,5,260,5,malware,avaddon
-9090702955997130072,10.127.0.54,10.127.0.3,445,tcp,-,15041,0,0,260,5,260,5,malware,avaddon
504126151331104586,10.127.0.54,10.127.0.3,139,tcp,-,15028,0,0,260,5,260,5,malware,avaddon
-5544837939946357866,10.127.0.54,10.127.0.4,445,tcp,-,15055,0,0,260,5,260,5,malware,avaddon
4049991167381876792,10.127.0.54,10.127.0.4,139,tcp,-,15014,0,0,260,5,260,5,malware,avaddon
7319560245089304070,10.127.0.54,10.127.0.5,445,tcp,-,15043,0,0,260,5,260,5,malware,avaddon
-1532354721292012888,10.127.0.54,10.127.0.5,139,tcp,-,15044,0,0,260,5,260,5,malware,avaddon
-1255427278856222323,10.127.0.54,10.127.0.6,445,tcp,-,3008,0,0,156,3,156,3,malware,avaddon
7496582001386603543,10.127.0.54,10.127.0.6,139,tcp,-,3012,0,0,156,3,156,3,malware,avaddon
5497794521808426023,10.127.0.178,8.8.8.8,53,udp,dns,2311,9155,64,4585,64,13740,128,normal,-
2393210334536794308,10.127.0.178,172.64.205.35,443,tcp,http,109738,4678,11,837,10,5515,21,malware,avaddon
-7093618539229402160,10.127.0.108,172.64.205.35,443,tcp,tls,109906,7226,17,1531,21,8757,38,malware,avaddon
-6933537433193163459,10.127.0.108,10.127.0.1,445,tcp,-,15039,0,0,260,5,260,5,malware,avaddon
-8739423110939623592,10.127.0.108,10.127.0.1,139,tcp,-,15061,0,0,260,5,260,5,malware,avaddon
-4266554910752214769,10.127.0.108,10.127.0.2,445,tcp,-,15012,0,0,260,5,260,5,malware,avaddon
4485454369490611097,10.127.0.108,10.127.0.2,139,tcp,-,15045,0,0,260,5,260,5,malware,avaddon
-2563851778830650669,10.127.0.108,10.127.0.3,445,tcp,-,15045,0,0,260,5,260,5,malware,avaddon
-4369737456577110802,10.127.0.108,10.127.0.3,139,tcp,-,15045,0,0,260,5,260,5,malware,avaddon
-3416344145764246591,10.127.0.108,10.127.0.4,445,tcp,-,15013,0,0,260,5,260,5,malware,avaddon
-823872440526338596,10.127.0.108,10.127.0.4,139,tcp,-,7045,0,0,208,4,208,4,malware,avaddon
3422711343536872912,10.127.0.127,192.229.232.200,443,tcp,http,110189,9401,19,1777,21,11178,40,malware,avaddon
-4458515899785537392,10.127.0.127,13.85.23.86,443,tcp,http,105435,5680,8,1093,13,6773,21,malware,avaddon
7356489238468798791,10.127.0.127,172.64.205.35,443,tcp,http,104114,4235,10,946,13,5181,23,malware,avaddon
3088072670375720297,10.127.0.127,10.127.0.1,445,tcp,-,15040,0,0,260,5,260,5,malware,avaddon
1282186992629260164,10.127.0.127,10.127.0.1,139,tcp,-,15031,0,0,260,5,260,5,malware,avaddon
-9106011033848974226,10.127.0.127,10.127.0.2,445,tcp,-,15029,0,0,260,5,260,5,malware,avaddon
488818073479260432,10.127.0.127,10.127.0.2,139,tcp,-,15030,0,0,260,5,260,5,malware,avaddon
-5245033984014967211,10.127.0.127,10.127.0.3,445,tcp,-,15028,0,0,260,5,260,5,malware,avaddon
4349795123313267447,10.127.0.127,10.127.0.3,139,tcp,-,15045,0,0,260,5,260,5,malware,avaddon
-1699168967964195005,10.127.0.127,10.127.0.4,445,tcp,-,15028,0,0,260,5,260,5,malware,avaddon
7895660139364039653,10.127.0.127,10.127.0.4,139,tcp,-,15014,0,0,260,5,260,5,malware,avaddon
8469063951049259645,10.127.0.127,10.127.0.5,445,tcp,-,15029,0,0,260,5,260,5,malware,avaddon
6663178273302799512,10.127.0.127,10.127.0.5,139,tcp,-,15012,0,0,260,5,260,5,malware,avaddon
-3966389607770870505,10.127.0.127,10.127.0.6,445,tcp,-,2996,0,0,156,3,156,3,malware,avaddon
-5772275285517330638,10.127.0.127,10.127.0.6,139,tcp,-,3005,0,0,156,3,156,3,malware,avaddon
6899699466283416093,10.127.0.113,192.229.232.200,443,tcp,-,102012,9480,19,1628,19,11108,38,malware,avaddon
1297157996590796196,10.127.0.113,40.125.122.176,443,tcp,http,87728,5722,8,940,9,6662,17,malware,avaddon
3807473326163258057,10.127.0.113,173.223.113.131,80,tcp,http,63194,2798,4,415,5,3213,9,normal,-
-5051024525985192644,10.127.0.113,8.241.137.254,80,tcp,http,86728,72144,134,6191,115,78335,249,malware,avaddon
-6849080536925468508,10.127.0.113,172.64.205.35,443,tcp,http,84761,4169,11,831,10,5000,21,malware,avaddon
-4556587003979004140,10.127.0.119,217.8.117.63,80,tcp,-,4614,400,10,520,10,920,20,malware,avaddon
-8380711759797336359,10.127.0.100,172.64.204.35,443,tcp,http,114544,4662,11,837,10,5499,21,malware,avaddon
-9222700910468416070,10.127.0.177,52.167.17.97,443,tcp,-,-1,0,0,0,0,0,0,malware,avaddon
-709859879150420692,10.127.0.75,93.184.221.240,80,tcp,-,52939,0,0,904,19,904,19,malware,avaddon
-4078959388933621826,10.127.0.75,10.127.0.1,445,tcp,-,15044,0,0,260,5,260,5,malware,avaddon
4673049891309204040,10.127.0.75,10.127.0.1,139,tcp,-,15011,0,0,260,5,260,5,malware,avaddon
497082267050139977,10.127.0.75,52.152.110.14,443,tcp,-,187376,0,0,3328,64,3328,64,malware,avaddon
3554412155746408430,10.127.0.75,10.127.0.2,445,tcp,-,15023,0,0,260,5,260,5,malware,avaddon
1748526477999948297,10.127.0.75,10.127.0.2,139,tcp,-,15059,0,0,260,5,260,5,malware,avaddon
926595743213828457,10.127.0.75,173.223.113.164,443,tcp,-,37905,0,0,644,14,644,14,malware,avaddon
-1870157833653545681,10.127.0.75,173.223.113.131,80,tcp,-,37906,0,0,644,14,644,14,malware,avaddon
-5233555919769029470,10.127.0.75,204.79.197.203,80,tcp,-,37905,0,0,644,14,644,14,malware,avaddon
-8013708660339941206,10.127.0.75,10.127.0.3,445,tcp,-,15042,0,0,260,5,260,5,malware,avaddon
1581120446988293452,10.127.0.75,10.127.0.3,139,tcp,-,15045,0,0,260,5,260,5,malware,avaddon
3072405105910922034,10.127.0.75,10.127.0.4,445,tcp,-,15044,0,0,260,5,260,5,malware,avaddon
1266519428164461901,10.127.0.75,10.127.0.4,139,tcp,-,15029,0,0,260,5,260,5,malware,avaddon
1839923239849681893,10.127.0.75,10.127.0.5,445,tcp,-,15042,0,0,260,5,260,5,malware,avaddon
34037562103221760,10.127.0.75,10.127.0.5,139,tcp,-,15030,0,0,260,5,260,5,malware,avaddon
-1421847436496613409,10.127.0.174,8.8.8.8,53,udp,dns,16420,23006,171,12341,176,35347,347,normal,-
-4703828604992733014,10.127.0.174,172.64.204.35,443,tcp,tls,58667,7187,16,1699,24,8886,40,malware,avaddon
8288838489291534708,10.127.0.174,20.189.173.9,443,tcp,-,103902,0,0,1610,35,1610,35,malware,avaddon
4147977604139293314,10.127.0.174,172.64.205.35,443,tcp,-,15048,0,0,260,5,260,5,malware,avaddon
-6663693697702067607,10.127.0.174,10.127.0.1,445,tcp,-,15010,0,0,260,5,260,5,malware,avaddon
7329492792610535179,10.127.0.174,10.127.0.1,139,tcp,-,15047,0,0,260,5,260,5,malware,avaddon
5355676379742866429,10.127.0.174,8.241.131.254,80,tcp,-,2,120,3,138,3,258,6,malware,avaddon
4830143881852566406,10.127.0.174,10.127.0.2,445,tcp,-,15057,0,0,260,5,260,5,malware,avaddon
-4864590911614159344,10.127.0.174,10.127.0.2,139,tcp,-,15029,0,0,260,5,260,5,malware,avaddon
-4025047944215155493,10.127.0.174,10.127.0.3,445,tcp,-,1010,0,0,104,2,104,2,malware,avaddon
4726961336027670373,10.127.0.174,10.127.0.3,139,tcp,-,1013,0,0,104,2,104,2,malware,avaddon
-4358987459642103572,10.127.0.178,93.184.221.240,80,tcp,-,91895,0,0,1686,36,1686,36,malware,avaddon
-5498538190470244984,10.127.0.52,10.127.0.1,445,tcp,-,15002,0,0,260,5,260,5,malware,avaddon
-1144886293211787246,10.127.0.52,10.127.0.1,139,tcp,-,15142,0,0,260,5,260,5,malware,avaddon
9058557104783444279,10.127.0.52,10.127.0.2,445,tcp,-,15011,0,0,260,5,260,5,malware,avaddon
206642138402127321,10.127.0.52,10.127.0.2,139,tcp,-,15029,0,0,260,5,260,5,malware,avaddon
-5527209919092100322,10.127.0.52,10.127.0.3,445,tcp,-,15011,0,0,260,5,260,5,malware,avaddon
4067619188236134336,10.127.0.52,10.127.0.3,139,tcp,-,15060,0,0,260,5,260,5,malware,avaddon
-1981344903041328116,10.127.0.52,10.127.0.4,445,tcp,-,15058,0,0,260,5,260,5,malware,avaddon
7613484204286906542,10.127.0.52,10.127.0.4,139,tcp,-,15029,0,0,260,5,260,5,malware,avaddon
-1026316092240001701,10.127.0.184,172.64.204.35,443,tcp,-,15014,0,0,260,5,260,5,malware,avaddon
-7973582051167038292,10.127.0.184,172.64.205.35,443,tcp,http,88768,4060,9,900,12,4960,21,malware,avaddon
5440559278880693694,10.127.0.184,10.127.0.1,445,tcp,-,15005,0,0,260,5,260,5,malware,avaddon
-4254175514586032056,10.127.0.184,10.127.0.1,139,tcp,-,15031,0,0,260,5,260,5,malware,avaddon
4647190359730693962,10.127.0.184,10.127.0.2,445,tcp,-,15028,0,0,260,5,260,5,malware,avaddon
7239662064968601957,10.127.0.184,10.127.0.2,139,tcp,-,15045,0,0,260,5,260,5,malware,avaddon
-4208001466337027937,10.127.0.184,10.127.0.3,445,tcp,-,15059,0,0,260,5,260,5,malware,avaddon
-6013887144083488070,10.127.0.184,10.127.0.3,139,tcp,-,15029,0,0,260,5,260,5,malware,avaddon
-662136450286255731,10.127.0.184,10.127.0.4,445,tcp,-,15027,0,0,260,5,260,5,malware,avaddon
8089872829956570135,10.127.0.184,10.127.0.4,139,tcp,-,15046,0,0,260,5,260,5,malware,avaddon
-7625193514155318574,10.127.0.184,10.127.0.5,445,tcp,-,1011,0,0,104,2,104,2,malware,avaddon
9015664881807772909,10.127.0.184,10.127.0.5,139,tcp,-,1014,0,0,104,2,104,2,malware,avaddon
5489293720449178188,10.127.0.192,172.64.204.35,443,tcp,http,114748,4177,11,831,10,5008,21,malware,avaddon
1347809059430222932,10.127.0.95,217.8.117.63,80,tcp,-,4008,240,6,304,6,544,12,malware,avaddon
4592294163259899198,10.127.0.105,10.127.0.1,445,tcp,-,15088,0,0,260,5,260,5,malware,avaddon
138736579862950368,10.127.0.105,10.127.0.1,139,tcp,-,15233,0,0,260,5,260,5,malware,avaddon
3369962866912804297,10.127.0.105,10.127.0.2,445,tcp,-,15012,0,0,260,5,260,5,malware,avaddon
1564077189166344164,10.127.0.105,10.127.0.2,139,tcp,-,15046,0,0,260,5,260,5,malware,avaddon
7230939916746811312,10.127.0.105,10.127.0.3,445,tcp,-,15058,0,0,260,5,260,5,malware,avaddon
-2463794876719914438,10.127.0.105,10.127.0.3,139,tcp,-,15030,0,0,260,5,260,5,malware,avaddon
-1510401565907050227,10.127.0.105,10.127.0.4,445,tcp,-,15042,0,0,260,5,260,5,malware,avaddon
1082070139330857768,10.127.0.105,10.127.0.4,139,tcp,-,15046,0,0,260,5,260,5,malware,avaddon
-1362172256773117205,10.127.0.105,10.127.0.5,445,tcp,-,15028,0,0,260,5,260,5,malware,avaddon
-3168057934519577338,10.127.0.105,10.127.0.5,139,tcp,-,15045,0,0,260,5,260,5,malware,avaddon
-2891130492083786773,10.127.0.105,10.127.0.6,445,tcp,-,3011,0,0,156,3,156,3,malware,avaddon
6703698615244447885,10.127.0.105,10.127.0.6,139,tcp,-,1013,0,0,104,2,104,2,malware,avaddon
6330017529681414842,10.127.0.76,46.148.39.36,80,tcp,http,3496,1756,24,2872,24,4628,48,malware,loki
-2151261051464275845,10.127.0.215,8.8.8.8,53,udp,dns,275,71,1,55,1,126,2,normal,-
-8456591264308789143,10.127.0.215,162.240.35.239,443,tcp,tls,18298,8760,200,12620,200,21380,400,malware,loki
5728860695062624541,10.127.0.186,185.246.220.85,80,tcp,http,1063,1808,24,2896,24,4704,48,malware,loki
63280311392655028,10.127.0.178,40.126.31.69,443,tcp,-,15157,0,0,260,5,260,5,malware,loki
3696634554714866873,10.127.0.178,20.44.10.123,443,tcp,-,18968,0,0,322,7,322,7,malware,loki
926766268464502896,10.127.0.178,93.184.220.29,80,tcp,-,37921,0,0,644,14,644,14,malware,loki
503552440004448860,10.127.0.178,209.197.3.8,80,tcp,-,18968,0,0,322,7,322,7,malware,loki
434183632568958811,10.127.0.178,173.223.113.164,443,tcp,-,75810,0,0,1288,28,1288,28,malware,loki
-1120928031160860433,10.127.0.178,173.223.113.131,80,tcp,-,18953,0,0,322,7,322,7,malware,loki
3893920986181967177,10.127.0.178,204.79.197.203,80,tcp,-,18952,0,0,322,7,322,7,malware,loki
2329083686712984707,10.127.0.178,117.18.232.240,80,tcp,-,0,0,0,46,1,46,1,malware,loki
-6702866032786740745,10.127.0.57,8.248.3.254,80,tcp,-,75789,0,0,1288,28,1288,28,malware,loki
-4432315236981335952,10.127.0.57,20.50.73.9,443,tcp,-,37878,0,0,644,14,644,14,malware,loki
-342371095793134867,10.127.0.57,8.8.8.8,53,udp,dns,1017,6746,46,3299,46,10045,92,normal,-
5994732800042092712,10.127.0.57,173.223.113.164,443,tcp,-,56920,0,0,966,21,966,21,malware,loki
-8276547739589455446,10.127.0.57,173.223.113.131,80,tcp,-,37984,0,0,644,14,644,14,malware,loki
-8992273920054450538,10.127.0.57,204.79.197.203,80,tcp,-,37921,0,0,644,14,644,14,malware,loki
-165355873929418470,10.127.0.57,52.152.110.14,443,tcp,-,198946,0,0,3536,68,3536,68,malware,loki
401453929317671280,10.127.0.57,171.22.30.147,80,tcp,http,1552,1808,24,2900,24,4708,48,malware,loki
-7051740643068447765,10.127.0.164,67.24.35.254,80,tcp,-,113703,0,0,1932,42,1932,42,malware,loki
2134358663079691737,10.127.0.164,8.8.8.8,53,udp,dns,2845,8980,64,4521,64,13501,128,normal,-
-3358765702323463955,10.127.0.164,52.152.110.14,443,tcp,-,262552,0,0,4628,89,4628,89,malware,loki
-3888770494823084025,10.127.0.164,20.189.173.9,443,tcp,-,42170,0,0,644,14,644,14,malware,loki
1282532446192572429,10.127.0.164,68.183.13.128,80,tcp,http,16993,101448,87,6038,92,107486,179,malware,loki
8471462558914919316,10.127.0.164,173.223.113.164,443,tcp,-,94763,0,0,1610,35,1610,35,malware,loki
-1771434899870966982,10.127.0.164,173.223.113.131,80,tcp,-,94766,0,0,1610,35,1610,35,malware,loki
-784968963373801232,10.127.0.164,204.79.197.203,80,tcp,-,37905,0,0,644,14,644,14,malware,loki
3224360651246942844,10.127.0.70,171.22.30.147,80,tcp,http,1139,1808,24,2900,24,4708,48,malware,loki
-8853202284657459789,10.127.0.177,152.195.38.76,80,tcp,-,2,80,2,92,2,172,4,malware,loki
9098007618319734380,10.127.0.177,85.217.144.248,80,tcp,http,30272,364943,264,8443,178,373386,442,malware,loki
5908194188077733613,10.127.0.177,185.246.220.60,80,tcp,http,1760,1808,24,2896,24,4704,48,malware,loki
-8594550567811683817,10.127.0.120,85.31.45.28,80,tcp,http,239,225446,162,4330,87,229776,249,malware,loki
-2475648700916440283,10.127.0.104,103.167.92.45,80,tcp,-,7471,200,5,304,6,504,11,malware,loki
6754872188468037930,10.127.0.104,31.47.0.165,80,tcp,-,38,80,2,46,1,126,3,malware,loki
-3551125622129904216,10.127.0.172,162.19.139.184,2222,tcp,-,1,390,1,46,1,436,2,malware,loki
-4598949642689216253,10.127.0.172,46.148.39.36,80,tcp,-,34005,1756,24,3392,34,5148,58,malware,loki
4858202086439542261,10.127.0.17,107.174.45.14,80,tcp,-,11271,179386,130,3832,76,183218,206,malware,loki
-8101526755312235943,10.127.0.174,46.148.39.36,80,tcp,http,5069,2199,30,3532,30,5731,60,malware,loki
-6786484524462261509,10.127.0.96,85.217.144.248,80,tcp,http,38109,364943,264,6695,140,371638,404,malware,loki
7000589879851909317,10.127.0.116,68.183.13.128,80,tcp,-,46063,39504,35,3475,52,42979,87,malware,loki
4858174308022966844,10.127.0.123,185.246.220.85,80,tcp,-,15923,1808,24,3160,29,4968,53,malware,loki
-330555905573148194,10.127.0.187,93.184.220.29,80,tcp,-,14995,0,0,260,5,260,5,malware,loki
-1252652017632380759,10.127.0.187,52.152.110.14,443,tcp,-,412037,0,0,8886,156,8886,156,malware,loki
1472431703527151906,10.127.0.187,171.22.30.147,80,tcp,http,2845,3616,48,5812,48,9428,96,malware,loki
-6335380560046141193,10.127.0.109,171.22.30.147,80,tcp,-,31463,1352,18,2713,27,4065,45,malware,loki
-7440075778461095404,10.127.0.173,79.110.62.143,80,tcp,http,2867,1216,3,560,5,1776,8,malware,loki
-5675206202438068605,10.127.0.196,107.174.45.14,80,tcp,http,3495,634,2,553,5,1187,7,malware,loki
-329936483283796965,10.127.0.170,46.148.39.36,80,tcp,http,34024,1313,18,2784,29,4097,47,malware,loki
861019937895606343,10.127.0.175,103.167.84.121,80,tcp,http,3482,832118,596,14722,313,846840,909,malware,loki
2660032238947655411,10.127.0.56,8.8.8.8,53,udp,dns,7674,3422,23,2013,28,5435,51,normal,-
-3512213861842886190,10.127.0.56,20.42.65.90,443,tcp,-,37885,0,0,644,14,644,14,malware,loki
2223235266307051357,10.127.0.56,117.18.237.29,80,tcp,-,99341,0,0,644,14,644,14,malware,loki
-6362592923701983612,10.127.0.56,209.197.3.8,80,tcp,-,90841,0,0,1548,33,1548,33,malware,loki
-2403578650291811801,10.127.0.56,173.223.113.164,443,tcp,-,37907,0,0,644,14,644,14,malware,loki
-1586980076169215530,10.127.0.122,152.195.38.76,80,tcp,-,3,120,3,138,3,258,6,malware,loki
-791226491612016460,10.127.0.122,117.18.232.240,80,tcp,-,1,120,3,138,3,258,6,malware,loki
-7788311904235692199,10.127.0.122,162.240.35.239,443,tcp,-,13059,570648,432,11882,231,582530,663,malware,loki
3882079034322190149,10.127.0.100,171.22.30.164,80,tcp,http,1308,1808,24,2896,24,4704,48,malware,loki
-2146095988668111674,10.127.0.100,84.53.175.11,80,tcp,-,18952,0,0,322,7,322,7,malware,loki
2471066097760441847,10.127.0.121,107.174.45.14,80,tcp,http,421,634,2,508,4,1142,6,malware,loki
938360999555343705,10.127.0.112,208.67.105.148,80,tcp,http,1020,1808,24,2854,23,4662,47,malware,loki
-841040997674165899,10.127.0.167,171.22.30.147,80,tcp,http,912,1808,24,2900,24,4708,48,malware,loki
9113383856422743165,10.127.0.172,142.251.36.46,443,tcp,http,120044,13771,20,1876,16,15647,36,malware,loki
-8619963056825079049,10.127.0.172,142.250.179.193,443,tcp,http,117799,601422,444,12530,233,613952,677,malware,loki
2449073380268174729,10.127.0.59,46.148.39.36,80,tcp,http,3518,1756,24,2872,24,4628,48,malware,loki
-1655824333647464962,10.127.0.159,8.8.8.8,53,udp,dns,250,3111,21,1513,21,4624,42,normal,-
-1859492472355951402,10.127.0.159,185.246.220.60,80,tcp,http,1335,2304,31,3567,30,5871,61,malware,loki
7412884345080662879,10.127.0.159,20.189.173.7,443,tcp,-,37906,0,0,644,14,644,14,malware,loki
-7084108640968677362,10.127.0.159,93.184.221.240,80,tcp,-,75810,0,0,1288,28,1288,28,malware,loki
4681279562187762617,10.127.0.159,173.223.113.164,443,tcp,-,37906,0,0,644,14,644,14,malware,loki
1168799804855393387,10.127.0.159,204.79.197.203,80,tcp,-,37906,0,0,644,14,644,14,malware,loki
-683339562295441146,10.127.0.177,52.152.110.14,443,tcp,-,262769,0,0,4628,89,4628,89,malware,loki
511378521648312669,10.127.0.177,13.69.239.73,443,tcp,-,56859,0,0,966,21,966,21,malware,loki
-7750026829271177428,10.127.0.100,46.148.39.36,80,tcp,http,19650,2199,30,3792,35,5991,65,malware,loki
-4666683127510592975,10.127.0.75,171.22.30.147,80,tcp,http,1413,1808,24,2854,23,4662,47,malware,loki
-5123555163379263478,10.127.0.171,8.238.20.126,80,tcp,-,37947,0,0,644,14,644,14,malware,loki
6305558495574890849,10.127.0.171,208.67.105.148,80,tcp,-,31261,1808,24,3328,32,5136,56,malware,loki
-389470607589235891,10.127.0.171,52.152.110.14,443,tcp,-,142318,0,0,2548,49,2548,49,malware,loki
-6031198007432567603,10.127.0.171,20.189.173.5,443,tcp,-,21483,0,0,322,7,322,7,malware,loki
40042868574452589,10.127.0.171,173.223.113.164,443,tcp,-,37905,0,0,644,14,644,14,malware,loki
1981484936962770605,10.127.0.171,23.55.97.181,80,tcp,-,18953,0,0,322,7,322,7,malware,loki
7076513595599514646,10.127.0.171,131.253.33.203,80,tcp,-,18952,0,0,322,7,322,7,malware,loki
-2808625834524774000,10.127.0.184,208.67.105.179,80,tcp,http,4244,793981,578,14124,300,808105,878,malware,loki
-1963295923791530193,10.127.0.67,68.183.13.128,80,tcp,http,1911,79088,72,5272,76,84360,148,malware,loki
5245360487550560713,10.127.0.65,171.22.30.164,80,tcp,http,1364,1808,24,2892,24,4700,48,malware,loki
5085445337437110887,10.127.0.101,46.148.39.36,80,tcp,http,3756,1756,24,2826,23,4582,47,malware,loki
337205643816657942,10.127.0.101,185.199.110.153,443,tcp,tls,1,209,3,138,3,347,6,malware,loki
208424549919462350,10.127.0.109,208.67.105.148,80,tcp,-,16436,2236,29,4071,35,6307,64,malware,loki
8878805759485470731,10.127.0.109,13.69.239.73,443,tcp,-,18953,0,0,322,7,322,7,malware,loki
-3838995636605522438,10.127.0.109,204.79.197.203,80,tcp,-,18952,0,0,322,7,322,7,malware,loki
5868426585041100485,10.127.0.66,171.22.30.147,80,tcp,http,1379,1808,24,2900,24,4708,48,malware,loki
-4805629578348794814,10.127.0.67,185.246.220.60,80,tcp,http,1622,2264,30,3567,30,5831,60,malware,loki
3236691060040267319,10.127.0.99,142.251.36.46,443,tcp,-,110050,10576,27,1818,22,12394,49,malware,loki
3950088220501996721,10.127.0.99,142.250.179.193,443,tcp,-,109109,595440,447,12202,234,607642,681,malware,loki
7125874105175526199,10.127.0.179,20.189.173.6,443,tcp,-,19078,0,0,322,7,322,7,malware,loki
-8004037245537560332,10.127.0.179,117.18.237.29,80,tcp,-,48610,0,0,322,7,322,7,malware,loki
-8597167197233800550,10.127.0.179,93.184.221.240,80,tcp,-,57454,0,0,966,21,966,21,malware,loki
-1230136377061728699,10.127.0.179,173.223.113.164,443,tcp,-,18951,0,0,322,7,322,7,malware,loki
-5359107768752557411,10.127.0.179,173.223.113.131,80,tcp,-,18953,0,0,322,7,322,7,malware,loki
-8233107867129995418,10.127.0.179,204.79.197.203,80,tcp,-,18952,0,0,322,7,322,7,malware,loki
-8805360754980606865,10.127.0.175,171.22.30.164,80,tcp,http,1075,1808,24,2892,24,4700,48,malware,loki
-167245546830148510,10.127.0.224,8.8.8.8,53,udp,dns,10790,2749,24,1954,29,4703,53,normal,-
-3140017585461861381,10.127.0.224,20.112.52.29,80,tcp,-,307,92,2,190,4,282,6,normal,-
5979342345038519670,10.127.0.224,40.93.207.1,25,tcp,-,9752,0,0,152,3,152,3,malware,coinminer
4842519982336472961,10.127.0.224,98.136.96.77,25,tcp,-,10164,0,0,152,3,152,3,malware,coinminer
7256453648229493424,10.127.0.224,80.66.75.254,443,tcp,https,347,582,6,355,5,937,11,malware,coinminer
-3588242524310234192,10.127.0.224,142.250.102.27,25,tcp,-,10165,0,0,152,3,152,3,malware,coinminer
-4482741111921416919,10.127.0.224,80.66.75.254,483,tcp,-,2815,570936,438,13123,235,584059,673,malware,coinminer
4291088362279851805,10.127.0.224,176.113.115.154,419,tcp,-,22843,1351,7,388,7,1739,14,malware,coinminer
3902121998479808007,10.127.0.224,176.113.115.155,419,tcp,-,22014,1351,7,388,7,1739,14,malware,coinminer
6400284032786758939,10.127.0.224,176.113.115.136,419,tcp,-,22843,1351,7,388,7,1739,14,malware,coinminer
4595823712473381518,10.127.0.224,142.251.39.100,80,tcp,http,30948,9146,18,2385,27,11531,45,normal,-
-7462590855074393500,10.127.0.224,94.100.180.31,25,tcp,-,9277,0,0,152,3,152,3,malware,coinminer
4158773805781528131,10.127.0.224,69.192.67.3,443,tcp,tls,849,17017,21,1594,14,18611,35,normal,-
3796212171553603177,10.127.0.224,52.101.9.10,25,tcp,-,10164,0,0,152,3,152,3,malware,coinminer
-8210157309299461608,10.127.0.224,81.88.52.104,443,tcp,tls,779,1860,15,8298,19,10158,34,malware,coinminer
618472949989609557,10.127.0.224,37.1.217.172,25000,tcp,http,16,612,6,530,6,1142,12,malware,coinminer
1299435111117824859,10.127.0.224,81.88.48.78,80,tcp,http,115,956,10,924,10,1880,20,malware,coinminer
-1206216297635896779,10.127.0.224,109.234.160.78,80,tcp,http,73,1017,6,3883,7,4900,13,malware,coinminer
-382491429538123051,10.127.0.224,199.188.200.125,80,tcp,http,773,479,6,4181,8,4660,14,malware,coinminer
-5981158027555648423,10.127.0.215,179.43.140.229,80,tcp,http,5194,5002284,3630,262591,2569,5264875,6199,malware,coinminer
8610724766229653896,10.127.0.128,179.43.140.229,80,tcp,http,5449,5089412,3705,289863,2887,5379275,6592,malware,coinminer
8178054196319716147,10.127.0.128,51.15.58.224,14433,tcp,tls,79386,6321,14,1489,11,7810,25,malware,coinminer
2933743216332824624,10.127.0.183,109.206.243.140,80,tcp,-,91280,167776,138,7351,113,175127,251,malware,coinminer
1421751616374119096,10.127.0.183,20.207.73.82,443,tcp,http,66984,226001,171,4661,91,230662,262,normal,-
-8041470820986334312,10.127.0.11,179.43.140.229,80,tcp,http,76602,5675997,4115,242545,2428,5918542,6543,malware,coinminer
661009741760745946,10.127.0.11,149.56.27.47,3956,tcp,-,96899,4165,23,12653,23,16818,46,malware,coinminer
-6988146961980238944,10.127.0.14,185.17.0.22,44810,tcp,-,8132,1032,8,546,9,1578,17,malware,coinminer
5302819994165870847,10.127.0.14,45.15.159.181,80,tcp,http,15197,2488443,1881,43872,951,2532315,2832,malware,coinminer
-8041442971868706916,10.127.0.115,20.189.173.6,443,tcp,-,19390,0,0,322,7,322,7,malware,coinminer
-1703568023652471328,10.127.0.115,45.76.89.70,80,tcp,tls,1493,3112,8,1336,8,4448,16,malware,coinminer
-8416685113887894560,10.127.0.115,172.67.149.91,443,tcp,tls,295,6794,14,1056,11,7850,25,malware,coinminer
-2205996272199882591,10.127.0.115,95.179.241.203,80,tcp,tls,102420,6968,16,1929,15,8897,31,malware,coinminer
-6546178514320047323,10.127.0.115,13.107.4.50,80,tcp,-,57138,0,0,966,21,966,21,malware,coinminer
-5490958130596501232,10.127.0.115,173.223.113.164,443,tcp,-,19140,0,0,322,7,322,7,malware,coinminer
7540208244508627383,10.127.0.115,173.223.113.131,80,tcp,-,19078,0,0,322,7,322,7,malware,coinminer
7137018532178765258,10.127.0.115,131.253.33.203,80,tcp,-,19187,0,0,322,7,322,7,malware,coinminer
-4355287687262343511,10.127.0.115,88.221.25.155,80,tcp,-,19047,0,0,322,7,322,7,malware,coinminer
-4981062743498292079,10.127.0.191,172.67.181.144,80,tcp,http,109996,3231097,2441,76289,1324,3307386,3765,malware,coinminer
1530354962865554869,10.127.0.191,203.91.116.53,80,tcp,http,23761,2695130,2022,73869,1555,2768999,3577,malware,coinminer
-4002223016549075947,10.127.0.191,45.9.74.80,80,tcp,http,76158,1477305,1060,37442,732,1514747,1792,malware,coinminer
6215850057775056898,10.127.0.191,162.0.217.254,443,tcp,http,27864,49137,66,6234,87,55371,153,malware,coinminer
-1446004987768467022,10.127.0.191,79.137.206.226,80,tcp,http,5424,204232,157,7679,152,211911,309,malware,coinminer
69229983271304572,10.127.0.191,45.136.113.107,80,tcp,http,219744,3150230,2905,103752,2251,3253982,5156,malware,coinminer
-8205534327689202520,10.127.0.191,161.97.179.222,443,tcp,http,65421,209467,159,4339,84,213806,243,malware,coinminer
-4840714345556157893,10.127.0.191,104.21.8.227,443,tcp,http,14094,1325023,1053,30674,588,1355697,1641,malware,coinminer
-7373376280507259555,10.127.0.191,89.190.157.61,80,tcp,http,5701,278728,203,5061,106,283789,309,malware,coinminer
-1020900991466983857,10.127.0.191,77.73.134.27,80,tcp,http,125072,1481170,7873,1025555,22280,2506725,30153,malware,coinminer
-2669581194730871564,10.127.0.191,175.126.109.15,80,tcp,http,9007,32340,38,2351,42,34691,80,malware,coinminer
-954847762408984988,10.127.0.191,45.66.159.179,80,tcp,http,143993,3156,22,4588,28,7744,50,malware,coinminer
-7177359305154825958,10.127.0.191,149.154.167.99,443,tcp,http,24675,58174,60,4784,72,62958,132,malware,coinminer
-4371969926397188904,10.127.0.191,95.216.179.190,80,tcp,http,22111,8296440,5937,274623,5943,8571063,11880,malware,coinminer
-3472982149012328979,10.127.0.191,211.59.14.90,80,tcp,http,39021,16427,110,16787,130,33214,240,malware,coinminer
7389157485148469847,10.127.0.191,51.91.79.17,443,tcp,tls,66264,4944,8,859,9,5803,17,malware,coinminer
-7332553783019088296,10.127.0.191,190.211.254.211,80,tcp,http,62391,319414,337,5590,118,325004,455,malware,coinminer
1101815195011388748,10.127.0.191,80.66.64.210,80,tcp,http,10886,22689,400,921956,677,944645,1077,malware,coinminer
-4133149094132680233,10.127.0.191,104.26.12.31,443,tcp,tls,9119,3845,7,710,8,4555,15,malware,coinminer
-8658335856801408374,10.127.0.17,20.112.52.29,80,tcp,-,350,92,2,190,4,282,6,normal,-
9034223331931201376,10.127.0.17,40.93.212.0,25,tcp,-,9901,0,0,152,3,152,3,malware,coinminer
-853640705455152547,10.127.0.17,67.195.228.111,25,tcp,-,9856,0,0,152,3,152,3,malware,coinminer
-1847542470153961972,10.127.0.17,80.66.75.254,443,tcp,https,384,582,6,355,5,937,11,malware,coinminer
-6203913623714858488,10.127.0.17,142.250.27.26,25,tcp,-,9626,0,0,152,3,152,3,malware,coinminer
-8192017724255463689,10.127.0.17,80.66.75.254,486,tcp,-,3480,570936,438,13176,236,584112,674,malware,coinminer
-3159578759624129268,10.127.0.17,176.113.115.239,422,tcp,-,71150,3711,34,9983,26,13694,60,malware,coinminer
7986007291754859402,10.127.0.17,176.113.115.154,422,tcp,-,71333,16837,75,49352,84,66189,159,malware,coinminer
6216329752759642441,10.127.0.17,176.113.115.155,422,tcp,-,68928,4706,33,22412,36,27118,69,malware,coinminer
6608598549661434408,10.127.0.17,80.66.75.4,422,tcp,-,78720,4543,39,13856,32,18399,71,malware,coinminer
7963558148132649391,10.127.0.17,176.113.115.135,422,tcp,-,77626,8747,50,10902,35,19649,85,malware,coinminer
-1305511822812928255,10.127.0.17,176.113.115.136,422,tcp,-,77976,9411,115,131173,185,140584,300,malware,coinminer
3475862824118202653,10.127.0.17,142.251.39.100,80,tcp,http,2687,18292,36,3858,36,22150,72,normal,-
-5934879837779083668,10.127.0.17,94.100.180.31,25,tcp,-,10194,0,0,152,3,152,3,malware,coinminer
-1650242810772043502,10.127.0.17,157.240.221.63,443,tcp,tls,4323,38775,55,10382,42,49157,97,malware,coinminer
8989790258142953025,10.127.0.17,213.91.128.133,10060,tcp,-,43931,1413,5,552,5,1965,10,malware,coinminer
-1532982826828996928,10.127.0.17,185.231.155.57,443,tcp,tls,1017,4765,11,1308,9,6073,20,malware,coinminer
-3183530326151700546,10.127.0.17,52.223.241.7,443,tcp,tls,5868,5446,21,5661,23,11107,44,malware,coinminer
1973249545416555234,10.127.0.17,104.47.22.161,25,tcp,-,9960,0,0,152,3,152,3,malware,coinminer
7876062318768442544,10.127.0.17,157.240.196.63,443,tcp,tls,4240,21861,34,7918,27,29779,61,malware,coinminer
-2714945792536807041,10.127.0.17,23.72.252.162,443,tcp,tls,14649,120579,115,5795,69,126374,184,malware,coinminer
8637419317677171094,10.127.0.17,52.98.20.178,443,tcp,tls,7003,7155,11,1577,12,8732,23,malware,coinminer
6855841456670179151,10.127.0.17,52.98.18.50,443,tcp,-,205,52,1,98,2,150,3,malware,coinminer
-2810229172778104737,10.127.0.128,109.206.243.140,80,tcp,http,27022,197812,388,49346,425,247158,813,malware,coinminer
8454383713705869262,10.127.0.128,20.207.73.82,443,tcp,http,55330,451020,410,10524,214,461544,624,normal,-
-3658870887151591109,10.127.0.128,157.254.195.116,80,tcp,-,15009,0,0,260,5,260,5,malware,coinminer
6665992966903647639,10.127.0.128,185.47.40.36,443,tcp,http,30367,6245,14,998,11,7243,25,malware,coinminer
-4292745043664819553,10.127.0.128,87.238.33.7,443,tcp,http,1865,2784502,2000,68437,1276,2852939,3276,malware,coinminer
-4810146063932455712,10.127.0.128,104.192.141.1,443,tcp,http,24326,10213,15,1343,13,11556,28,malware,coinminer
-1230953134218490114,10.127.0.128,54.231.136.89,443,tcp,http,7132,1423277,1033,31162,625,1454439,1658,malware,coinminer
-264993905891906170,10.127.0.128,52.217.205.177,443,tcp,http,6911,114856,98,3740,54,118596,152,malware,coinminer
-2348789609494735445,10.127.0.128,164.132.200.171,15555,tcp,-,15050,0,0,260,5,260,5,malware,coinminer
3215941297976894977,10.127.0.128,144.76.136.153,443,tcp,http,32703,14785085,10584,290924,5806,15076009,16390,malware,coinminer
-3547580699656387531,10.127.0.128,185.199.109.153,443,tcp,http,126,105140,81,2446,43,107586,124,malware,coinminer
549121970881583662,10.127.0.128,51.91.79.17,443,tcp,http,384,4906,7,767,7,5673,14,malware,coinminer
4605708512398719273,10.127.0.128,104.20.138.65,443,tcp,http,769,5228,12,905,10,6133,22,malware,coinminer
-211814973281842364,10.127.0.128,31.14.70.247,443,tcp,tls,471,6754,9,940,8,7694,17,malware,coinminer
1647698192188365220,10.127.0.128,51.178.66.33,443,tcp,tls,373,23498,24,1226,15,24724,39,malware,coinminer
2295346510134749512,10.127.0.128,185.106.92.128,17092,tcp,-,6859,19071,297,2023027,1476,2042098,1773,malware,coinminer
4375229766452935978,10.127.0.128,37.220.87.13,40676,tcp,-,10281,25531,537,2025067,1536,2050598,2073,malware,coinminer
-7689928647192004739,10.127.0.128,146.70.106.55,80,tcp,-,15176,0,0,260,5,260,5,malware,coinminer
3538980279278549110,10.127.0.123,104.192.141.1,443,tcp,-,15001,0,0,260,5,260,5,malware,coinminer
-7360292811405498425,10.127.0.220,179.43.140.229,80,tcp,http,7211,5550284,4008,267449,2497,5817733,6505,malware,coinminer
-5764535196522909149,10.127.0.100,52.152.110.14,443,tcp,-,82901,0,0,1508,29,1508,29,malware,coinminer
-2646784454326473643,10.127.0.100,179.43.140.229,80,tcp,http,16969,5551436,4032,271517,2184,5822953,6216,malware,coinminer
-8529877000560443767,10.127.0.100,13.89.179.10,443,tcp,-,19047,0,0,322,7,322,7,malware,coinminer
6942479249871801800,10.127.0.100,51.15.65.182,14433,tcp,tls,90051,5443,12,1564,13,7007,25,malware,coinminer
8457620523196886833,10.127.0.100,93.184.221.240,80,tcp,-,19219,0,0,322,7,322,7,malware,coinminer
-882753805773897106,10.127.0.174,20.112.52.29,80,tcp,-,366,92,2,190,4,282,6,normal,-
-6668212182917248287,10.127.0.174,104.47.54.36,25,tcp,-,15018,0,0,260,5,260,5,malware,coinminer
-2090050023482622875,10.127.0.174,67.195.204.74,25,tcp,-,15061,0,0,260,5,260,5,malware,coinminer
6001851758563028525,10.127.0.174,80.66.75.254,443,tcp,https,446,582,6,401,6,983,12,malware,coinminer
5715050544012586908,10.127.0.174,142.250.102.27,25,tcp,-,15065,0,0,260,5,260,5,malware,coinminer
-1338985618603513690,10.127.0.174,80.66.75.254,483,tcp,-,2850,570976,439,12942,231,583918,670,malware,coinminer
6745368699290942665,10.127.0.174,213.91.128.133,10060,tcp,-,78747,1059,5,825,7,1884,12,malware,coinminer
3394442344935516171,10.127.0.174,176.113.115.239,427,tcp,-,75153,1459,17,6442,15,7901,32,malware,coinminer
5791806990717487174,10.127.0.174,176.113.115.154,427,tcp,-,75305,1916,18,6490,16,8406,34,malware,coinminer
4022129451722270213,10.127.0.174,176.113.115.155,427,tcp,-,74938,1916,18,6490,16,8406,34,malware,coinminer
-3890036677144769990,10.127.0.174,80.66.75.4,427,tcp,-,75814,1511,18,6492,16,8003,34,malware,coinminer
38782649287454461,10.127.0.174,176.113.115.135,427,tcp,-,75761,1916,18,6496,16,8412,34,malware,coinminer
8787494374854333262,10.127.0.174,176.113.115.136,427,tcp,-,75089,1459,17,6438,15,7897,32,malware,coinminer
-149269909928980870,10.127.0.174,142.251.39.100,80,tcp,http,3250,18294,36,4042,40,22336,76,normal,-
5746898808824288618,10.127.0.174,217.69.139.150,25,tcp,-,15195,0,0,260,5,260,5,malware,coinminer
-5054959408520500670,10.127.0.107,20.224.151.203,443,tcp,-,0,40,1,0,0,40,1,malware,coinminer
5500930668549380041,10.127.0.107,109.206.243.140,80,tcp,http,55876,195492,364,48288,416,243780,780,malware,coinminer
-2170598506414243358,10.127.0.107,20.207.73.82,443,tcp,http,78596,450815,335,9224,180,460039,515,normal,-
-6792097717443331284,10.127.0.107,157.254.195.116,80,tcp,-,15041,0,0,260,5,260,5,malware,coinminer
8769121872854495957,10.127.0.107,185.47.40.36,443,tcp,http,31009,6245,14,1154,14,7399,28,malware,coinminer
6795671062617501889,10.127.0.107,87.238.33.8,443,tcp,http,5098,2792822,2004,88849,1652,2881671,3656,malware,coinminer
927154049434019598,10.127.0.107,104.192.141.1,443,tcp,http,2597,10212,15,1395,14,11607,29,malware,coinminer
-5176473884598011165,10.127.0.107,52.217.86.252,443,tcp,http,8304,1532041,1117,38970,671,1571011,1788,malware,coinminer
5962370231832749333,10.127.0.107,164.132.200.171,15555,tcp,-,15097,0,0,260,5,260,5,malware,coinminer
3100360675474349767,10.127.0.107,144.76.136.153,443,tcp,http,51821,11922011,8545,247502,4753,12169513,13298,malware,coinminer
4763579141671097247,10.127.0.107,185.199.109.153,443,tcp,http,165,105561,82,2452,43,108013,125,malware,coinminer
3129706614401245738,10.127.0.107,51.91.79.17,443,tcp,tls,415,4905,7,813,8,5718,15,malware,coinminer
-2433595860677484944,10.127.0.107,104.20.138.65,443,tcp,tls,911,5227,12,951,11,6178,23,malware,coinminer
1127127757100264818,10.127.0.107,31.14.70.247,443,tcp,tls,494,6754,9,940,8,7694,17,malware,coinminer
-3486690213846423618,10.127.0.107,51.38.43.18,443,tcp,tls,367,23498,24,1226,15,24724,39,malware,coinminer
200597139150916047,10.127.0.107,167.235.133.96,43849,tcp,-,5400,4183,6,757,8,4940,14,malware,coinminer
5640360319145563931,10.127.0.107,37.220.87.13,40676,tcp,-,418,537,6,519,6,1056,12,malware,coinminer
-8378129070357081697,10.127.0.107,185.106.92.128,17092,tcp,-,243,7431,9,781,8,8212,17,malware,coinminer
-759479981059693124,10.127.0.107,146.70.106.55,80,tcp,-,0,0,0,52,1,52,1,malware,coinminer
-3448584594213241758,10.127.0.80,109.206.243.140,80,tcp,http,8351,198821,392,51370,433,250191,825,malware,coinminer
1656490717265814370,10.127.0.80,20.207.73.82,443,tcp,http,55500,454495,421,11058,221,465553,642,normal,-
7177300654177445890,10.127.0.80,157.254.195.116,80,tcp,-,15023,0,0,260,5,260,5,malware,coinminer
4217963993076242286,10.127.0.80,185.47.40.36,443,tcp,http,30357,6245,14,1044,12,7289,26,malware,coinminer
-3425626404427623871,10.127.0.80,87.238.33.8,443,tcp,http,2406,2928782,2105,101931,1769,3030713,3874,malware,coinminer
-976331924693745376,10.127.0.80,104.192.141.1,443,tcp,http,83280,10255,16,1325,13,11580,29,malware,coinminer
6813711469343655492,10.127.0.80,52.217.193.25,443,tcp,http,9362,1531990,1115,31984,604,1563974,1719,malware,coinminer
4058884257704984359,10.127.0.80,164.132.200.171,15555,tcp,-,15062,0,0,260,5,260,5,malware,coinminer
5595232084330952921,10.127.0.80,144.76.136.153,443,tcp,http,83435,14785436,10592,257697,5435,15043133,16027,malware,coinminer
2633509042017840937,10.127.0.80,185.199.108.153,443,tcp,http,76213,106672,85,2590,46,109262,131,malware,coinminer
-7091590852643880022,10.127.0.80,51.91.79.17,443,tcp,http,73374,4946,8,859,9,5805,17,malware,coinminer
8439522651637429609,10.127.0.80,104.20.138.65,443,tcp,tls,525,5202,12,905,10,6107,22,malware,coinminer
-3424030122677988853,10.127.0.80,31.14.70.247,443,tcp,tls,70643,8107,12,1084,11,9191,23,malware,coinminer
-1564516957207781269,10.127.0.80,51.178.66.33,443,tcp,tls,70394,23609,26,1364,18,24973,44,malware,coinminer
-2422663229987118914,10.127.0.80,37.220.87.13,40676,tcp,-,12516,18335,335,1333642,1013,1351977,1348,malware,coinminer
-4551039846677023969,10.127.0.80,185.106.92.128,17092,tcp,-,8239,18111,273,1318812,967,1336923,1240,malware,coinminer
-5310637860837946795,10.127.0.80,146.70.106.55,80,tcp,http,76728,5449464,5015,235150,5017,5684614,10032,malware,coinminer
-1109605338689579634,10.127.0.80,185.199.108.133,443,tcp,tls,16974,9719566,7023,171624,3655,9891190,10678,malware,coinminer
-6530208595158312224,10.127.0.80,167.235.133.96,43849,tcp,-,15903,19302,340,1270806,874,1290108,1214,malware,coinminer
7118218543537663033,10.127.0.66,20.112.52.29,80,tcp,-,335,92,2,190,4,282,6,normal,-
1258947988704832623,10.127.0.66,104.47.54.36,25,tcp,-,15020,0,0,260,5,260,5,malware,coinminer
7337630699852807631,10.127.0.66,67.195.204.73,25,tcp,-,15027,0,0,260,5,260,5,malware,coinminer
-4517732143524442181,10.127.0.66,80.66.75.254,443,tcp,https,383,582,6,401,6,983,12,malware,coinminer
-4358613892355457666,10.127.0.66,142.250.102.26,25,tcp,-,15035,0,0,260,5,260,5,malware,coinminer
-3784761189376654012,10.127.0.66,80.66.75.254,487,tcp,-,11712,569905,421,10326,217,580231,638,malware,coinminer
5369505001886140382,10.127.0.66,94.100.180.31,25,tcp,-,15067,0,0,260,5,260,5,malware,coinminer
805673150747722444,10.127.0.66,142.251.39.100,80,tcp,http,2884,18294,36,4134,42,22428,78,normal,-
-7081333853306671410,10.127.0.66,157.240.196.63,443,tcp,tls,14042,223110,202,17881,129,240991,331,malware,coinminer
-6109563604581592528,10.127.0.66,157.240.196.174,443,tcp,tls,14320,84395,118,19311,85,103706,203,normal,-
1876919600007084493,10.127.0.66,104.47.22.161,25,tcp,-,3011,0,0,156,3,156,3,malware,coinminer
3661430957627586732,10.127.0.13,179.43.140.229,80,tcp,http,4556,5550616,4016,262287,2483,5812903,6499,malware,coinminer
7369022395657761492,10.127.0.13,8.8.8.8,53,udp,dns,24,210,1,66,1,276,2,normal,-
-2318045211271156607,10.127.0.13,51.68.190.80,14433,tcp,tls,105419,9268,21,1651,14,10919,35,malware,coinminer
5046043527649208184,10.127.0.165,20.112.52.29,80,tcp,-,358,92,2,190,4,282,6,normal,-
-6091014167952230713,10.127.0.165,40.93.207.1,25,tcp,-,15047,0,0,260,5,260,5,malware,coinminer
2392428199626751012,10.127.0.165,20.190.159.75,443,tcp,-,45108,0,0,780,15,780,15,malware,coinminer
6869043520442624655,10.127.0.165,98.136.96.77,25,tcp,-,15031,0,0,260,5,260,5,malware,coinminer
-2404538813289491290,10.127.0.165,142.250.102.27,25,tcp,-,15032,0,0,260,5,260,5,malware,coinminer
-9163766887373906498,10.127.0.165,80.66.75.254,443,tcp,-,45536,582,6,1181,21,1763,27,malware,coinminer
7280101558933487108,10.127.0.165,94.100.180.31,25,tcp,-,15030,0,0,260,5,260,5,malware,coinminer
-7787930516558144701,10.127.0.165,80.66.75.254,484,tcp,-,2119,569905,421,10326,217,580231,638,malware,coinminer
-1912112006120899904,10.127.0.165,213.91.128.133,10060,tcp,-,247,956,4,547,5,1503,9,malware,coinminer
3491506532767107728,10.127.0.22,179.43.140.229,80,tcp,http,6056,5550976,4025,275193,2474,5826169,6499,malware,coinminer
3735725661814571903,10.127.0.22,8.8.8.8,53,udp,dns,28,210,1,66,1,276,2,normal,-
-5689385442739847688,10.127.0.22,51.15.58.224,14433,tcp,tls,103639,8426,19,1599,13,10025,32,malware,coinminer
-856657563887381628,10.127.0.19,20.207.73.82,443,tcp,tls,909,179,4,344,5,523,9,normal,-
8462955615680423741,10.127.0.163,20.112.52.29,80,tcp,-,295,92,2,190,4,282,6,normal,-
-7023966102533664695,10.127.0.163,40.93.207.1,25,tcp,-,15019,0,0,260,5,260,5,malware,coinminer
-3511311121506326622,10.127.0.163,67.195.228.111,25,tcp,-,15057,0,0,260,5,260,5,malware,coinminer
-5746854799342690941,10.127.0.163,80.66.75.254,443,tcp,https,326,582,6,355,5,937,11,malware,coinminer
968894752723104617,10.127.0.163,142.250.102.26,25,tcp,-,15198,0,0,260,5,260,5,malware,coinminer
-1918777927527407139,10.127.0.163,80.66.75.254,482,tcp,-,2439,570936,438,12955,231,583891,669,malware,coinminer
2885511257105488816,10.127.0.163,213.91.128.133,10060,tcp,-,42199,956,4,547,5,1503,9,malware,coinminer
-3273360805191306313,10.127.0.163,176.113.115.239,418,tcp,-,71992,14621,133,191049,171,205670,304,malware,coinminer
2141650048379859655,10.127.0.163,176.113.115.154,418,tcp,-,75153,1419,16,3497,12,4916,28,malware,coinminer
4326543412540825325,10.127.0.163,176.113.115.155,418,tcp,-,74869,13653,108,175035,165,188688,273,malware,coinminer
-6281787982348422164,10.127.0.163,80.66.75.4,418,tcp,-,70227,2934,31,9839,25,12773,56,malware,coinminer
6073771807913832275,10.127.0.163,176.113.115.135,418,tcp,-,76477,63790,360,268000,380,331790,740,malware,coinminer
-1419293868380105300,10.127.0.163,176.113.115.136,418,tcp,-,70868,95826,368,629196,554,725022,922,malware,coinminer
2150410222890483152,10.127.0.163,142.251.39.100,80,tcp,http,2260,18300,36,3904,37,22204,73,normal,-
628516676713462448,10.127.0.163,94.100.180.31,25,tcp,-,15180,0,0,260,5,260,5,malware,coinminer
-3422427382532340527,10.127.0.163,195.54.174.27,80,tcp,http,144,431,5,508,5,939,10,malware,coinminer
5181915397717532948,10.127.0.163,212.82.100.137,443,tcp,tls,30214,42586,40,1917,26,44503,66,malware,coinminer
-7272490144224773455,10.127.0.163,212.82.100.140,443,tcp,tls,45195,40417,64,55959,76,96376,140,malware,coinminer
7776119795327025414,10.127.0.163,149.154.167.99,443,tcp,-,11047,92,2,190,4,282,6,malware,coinminer
7229398883942105850,10.127.0.163,87.248.114.12,443,tcp,tls,61708,349536,283,11330,166,360866,449,malware,coinminer
6351505784432499665,10.127.0.163,188.125.72.139,443,tcp,tls,74091,18066,49,16357,53,34423,102,malware,coinminer
3638081208246272075,10.127.0.163,52.164.206.56,143,tcp,-,176,299,6,283,5,582,11,malware,coinminer
787196070709538492,10.127.0.163,20.44.209.209,443,tcp,tls,27155,96135,182,16637,138,112772,320,malware,coinminer
264657352130058487,10.127.0.163,104.244.42.66,443,tcp,tls,12579,165975,256,39773,190,205748,446,malware,coinminer
2813735210092271537,10.127.0.163,66.254.114.41,443,tcp,tls,60992,427045,402,25375,244,452420,646,normal,-
-3177935485184698916,10.127.0.163,152.199.40.9,443,tcp,tls,13224,35057,38,3611,23,38668,61,malware,coinminer
586817100352089140,10.127.0.163,64.210.158.38,443,tcp,tls,13986,49396,55,5559,39,54955,94,malware,coinminer
-6763038819626101569,10.127.0.163,52.98.145.114,993,tcp,tls,2281,6297,13,1012,12,7309,25,malware,coinminer
-1785503878305658584,10.127.0.163,52.97.133.194,993,tcp,tls,413,4479,7,764,7,5243,14,malware,coinminer
9025963942367519310,10.127.0.3,185.215.113.66,80,tcp,http,115227,134362,114,5652,94,140014,208,malware,coinminer
1342404661493391117,10.127.0.3,20.109.209.108,80,tcp,-,542,184,4,288,6,472,10,malware,coinminer
-7853543697446794390,10.127.0.3,2.189.239.234,40500,udp,-,0,0,0,64,1,64,1,malware,coinminer
-8770483855933864712,10.127.0.3,111.125.158.109,40500,tcp,-,1744,120,3,152,3,272,6,malware,coinminer
-7246361124095398612,10.127.0.3,212.112.107.11,40500,udp,-,0,0,0,64,1,64,1,malware,coinminer
-4679295349004805473,10.127.0.3,82.194.11.21,40500,tcp,-,10139,0,0,152,3,152,3,malware,coinminer
-785858040280581607,10.127.0.3,201.105.100.6,40500,udp,-,0,0,0,64,1,64,1,malware,coinminer
7225942379749310687,10.127.0.3,81.16.114.77,40500,udp,-,0,0,0,64,1,64,1,malware,coinminer
-4737195137592405463,10.127.0.3,186.92.194.119,40500,udp,-,0,0,0,64,1,64,1,malware,coinminer
-6691443307227705611,10.127.0.3,213.230.99.253,40500,udp,-,0,0,0,64,1,64,1,malware,coinminer
-7451210302301475831,10.127.0.3,45.247.13.30,40500,udp,-,0,0,0,64,1,64,1,malware,coinminer
-8227621512130340105,10.127.0.3,217.30.170.150,40500,tcp,-,1746,1260,5,412,8,1672,13,malware,coinminer
8109506007028331516,10.127.0.3,2.184.54.70,40500,udp,-,0,0,0,64,1,64,1,malware,coinminer
-2752458046289014946,10.127.0.3,87.237.234.23,40500,tcp,-,10139,0,0,152,3,152,3,malware,coinminer
2797207200979391811,10.127.0.3,192.168.1.4,40500,udp,-,0,0,0,64,1,64,1,malware,coinminer
-2747468690075765634,10.127.0.3,119.129.81.98,40500,udp,-,0,0,0,64,1,64,1,malware,coinminer
7160026470247727784,10.127.0.3,190.206.246.137,40500,udp,-,0,0,0,64,1,64,1,malware,coinminer
4854983365120516470,10.127.0.3,100.100.171.98,40500,udp,-,0,0,0,64,1,64,1,malware,coinminer
4891021726325241671,10.127.0.3,31.7.111.142,40500,udp,-,0,0,0,64,1,64,1,malware,coinminer
7807267436387108014,10.127.0.3,192.168.1.135,40500,tcp,-,9541,0,0,152,3,152,3,malware,coinminer
4373789529300494909,10.127.0.3,31.171.79.139,40500,udp,-,0,0,0,64,1,64,1,malware,coinminer
-815788985917383774,10.127.0.3,190.202.209.236,40500,udp,-,0,0,0,64,1,64,1,malware,coinminer
-5426564425663632252,10.127.0.3,190.205.144.140,40500,udp,-,0,0,0,64,1,64,1,malware,coinminer
-505807485796801376,10.127.0.3,188.211.118.77,40500,udp,-,0,0,0,64,1,64,1,malware,coinminer
1023368337966247219,10.127.0.3,213.230.91.92,40500,udp,-,0,0,0,64,1,64,1,malware,coinminer
2527753881010863482,10.127.0.3,213.230.68.92,40500,tcp,-,10139,0,0,152,3,152,3,malware,coinminer
5635538897893369995,10.127.0.3,5.236.171.255,40500,udp,-,0,0,0,64,1,64,1,malware,coinminer
-5875368352924494062,10.127.0.3,46.73.46.25,40500,udp,-,0,0,0,64,1,64,1,malware,coinminer
5914219134920940046,10.127.0.3,5.219.56.119,40500,udp,-,0,0,0,64,1,64,1,malware,coinminer
527729910770041225,10.127.0.3,217.219.195.111,40500,udp,-,0,0,0,64,1,64,1,malware,coinminer
-7159973845093129455,10.127.0.3,176.108.77.66,40500,udp,-,0,0,0,64,1,64,1,malware,coinminer
-3193539029858716495,10.127.0.103,209.197.3.8,80,tcp,-,103463,0,0,1746,36,1746,36,malware,coinminer
-7148065596154691012,10.127.0.103,179.43.140.229,80,tcp,http,19973,6249904,4532,384171,3554,6634075,8086,malware,coinminer
-8132135045997426353,10.127.0.103,52.178.17.3,443,tcp,-,38075,0,0,644,14,644,14,malware,coinminer
-6860658429947350877,10.127.0.103,135.125.238.108,14433,tcp,tls,68909,5443,12,1558,13,7001,25,malware,coinminer
1817841796658957886,10.127.0.193,179.43.140.229,80,tcp,-,35867,6233192,4459,233957,3822,6467149,8281,malware,coinminer
3772684934873729366,10.127.0.193,20.190.159.4,443,tcp,-,15046,0,0,260,5,260,5,malware,coinminer
-6574859365675273644,10.127.0.176,20.54.89.15,443,tcp,-,16013,0,0,208,4,208,4,malware,coinminer
-4130522273943882285,10.127.0.176,117.18.237.29,80,tcp,http,204033,1051,6,1820,33,2871,39,malware,coinminer
-6090569807400571302,10.127.0.176,52.152.110.14,443,tcp,-,45205,0,0,780,15,780,15,malware,coinminer
3999398045741241800,10.127.0.176,179.43.140.229,80,tcp,http,17737,7202092,5229,460015,4255,7662107,9484,malware,coinminer
-7335707592070582337,10.127.0.176,20.189.173.3,443,tcp,-,40640,0,0,644,14,644,14,malware,coinminer
-6642302844097118098,10.127.0.176,51.15.69.136,14433,tcp,tls,102964,5443,12,1558,13,7001,25,malware,coinminer
8715706839549478934,10.127.0.57,92.204.173.86,80,tcp,-,76205,0,0,1300,25,1300,25,malware,coinminer
7529491825125992591,10.127.0.57,141.94.96.144,3333,tcp,-,90077,4350,11,1107,12,5457,23,malware,coinminer
9154740275146934358,10.127.0.110,93.184.221.240,80,tcp,-,196875,0,0,3356,71,3356,71,malware,coinminer
6230096296327595999,10.127.0.110,8.8.8.8,53,udp,dns,3298,11431,84,6011,84,17442,168,normal,-
4189569014114455383,10.127.0.110,52.152.108.96,443,tcp,-,30208,0,0,520,10,520,10,malware,coinminer
6348494141749209457,10.127.0.110,20.44.10.122,443,tcp,-,37982,0,0,644,14,644,14,malware,coinminer
8981522345118915175,10.127.0.110,173.223.113.164,443,tcp,-,37904,0,0,644,14,644,14,malware,coinminer
8740418033041495211,10.127.0.110,185.17.0.22,44810,tcp,-,2593,1032,8,590,10,1622,18,malware,coinminer
-1813716467506314742,10.127.0.110,45.15.159.181,80,tcp,http,11060,2487991,1870,53826,1040,2541817,2910,malware,coinminer
7171636022964516996,10.127.0.110,162.19.139.184,2222,tcp,-,70155,1094,8,985,9,2079,17,malware,coinminer
-3406272464430885422,10.127.0.110,173.223.113.131,80,tcp,-,37905,0,0,644,14,644,14,malware,coinminer
-3809462176760747547,10.127.0.110,131.253.33.203,80,tcp,-,37904,0,0,644,14,644,14,malware,coinminer
-3034336161534089786,10.127.0.65,93.184.221.240,80,tcp,-,169960,0,0,2910,60,2910,60,malware,coinminer
-8049791971170431759,10.127.0.65,20.189.173.2,443,tcp,-,94757,0,0,1610,35,1610,35,malware,coinminer
-3308142402407275821,10.127.0.65,173.223.113.131,80,tcp,-,94788,0,0,1610,35,1610,35,malware,coinminer
-512002913517841739,10.127.0.65,204.79.197.203,80,tcp,-,94788,0,0,1610,35,1610,35,malware,coinminer
-5732239829160484116,10.127.0.65,109.206.243.140,80,tcp,http,54406,171794,169,12135,146,183929,315,malware,coinminer
-2007875692876601151,10.127.0.65,20.207.73.82,443,tcp,http,109069,226053,171,4661,91,230714,262,normal,-
1307967572186295129,10.127.0.65,157.254.195.116,80,tcp,-,14963,0,0,260,5,260,5,malware,coinminer
-2464048624855368200,10.127.0.65,185.47.40.36,443,tcp,-,15026,0,0,260,5,260,5,malware,coinminer
-686127431679978266,10.127.0.65,104.192.141.1,443,tcp,http,2385,10324,17,1383,14,11707,31,malware,coinminer
-193546066055186292,10.127.0.65,52.217.234.105,443,tcp,http,8115,1531943,1116,28330,569,1560273,1685,malware,coinminer
1775229022757742001,10.127.0.65,164.132.200.171,15555,tcp,-,7027,0,0,208,4,208,4,malware,coinminer
-7806821380972154119,10.127.0.76,117.18.232.240,80,tcp,-,1,80,2,92,2,172,4,malware,coinminer
-4439624441122423521,10.127.0.76,179.43.140.229,80,tcp,http,19673,7017844,5063,327979,2944,7345823,8007,malware,coinminer
9037781852884490894,10.127.0.76,45.76.89.70,5555,tcp,-,90639,4440,10,1066,11,5506,21,malware,coinminer
-2719689455668257023,10.127.0.162,104.21.18.99,80,tcp,http,109975,3230807,2433,70312,1261,3301119,3694,malware,coinminer
-2098844587900432023,10.127.0.162,187.212.210.37,80,tcp,http,11254,2690862,1940,65813,1418,2756675,3358,malware,coinminer
-8541618769729521771,10.127.0.162,45.9.74.80,80,tcp,http,76481,1477305,1060,32246,648,1509551,1708,malware,coinminer
-5448208635556913407,10.127.0.162,162.0.217.254,443,tcp,http,30066,49248,68,6326,89,55574,157,malware,coinminer
-1635536718336263307,10.127.0.162,79.137.206.226,80,tcp,http,5490,204232,157,7557,149,211789,306,malware,coinminer
6930549015165553539,10.127.0.162,45.136.113.107,80,tcp,http,220065,3162630,3215,103614,2248,3266244,5463,malware,coinminer
3892140440447634940,10.127.0.162,161.97.179.222,443,tcp,http,65426,209499,159,4339,84,213838,243,malware,coinminer
-1892768423808183751,10.127.0.162,89.190.157.61,80,tcp,http,5672,278728,203,5061,106,283789,309,malware,coinminer
-8047892283913149143,10.127.0.162,104.21.8.227,443,tcp,http,11868,1324289,1041,26002,538,1350291,1579,malware,coinminer
3187924660949587986,10.127.0.162,77.73.134.27,80,tcp,http,125041,1440158,6840,1047981,22754,2488139,29594,malware,coinminer
3869989462503261327,10.127.0.162,157.240.221.35,443,tcp,http,29282,306244,238,13968,135,320212,373,normal,-
683560997541855077,10.127.0.162,176.226.127.181,80,tcp,http,2860,32300,37,2351,42,34651,79,malware,coinminer
-5616549053650628630,10.127.0.162,45.66.159.179,80,tcp,http,144402,3076,20,4588,28,7664,48,malware,coinminer
-7856289023460668025,10.127.0.162,149.154.167.99,443,tcp,tls,28842,58169,60,4782,72,62951,132,malware,coinminer
-3718681829879576397,10.127.0.162,95.216.179.190,80,tcp,http,26755,8303097,6090,782222,6318,9085319,12408,malware,coinminer
-7160325580870054293,10.127.0.162,109.206.243.140,80,tcp,http,27620,189145,343,42618,365,231763,708,malware,coinminer
-4012770779467842634,10.127.0.162,45.159.189.105,80,tcp,http,181694,6786,24,3140,38,9926,62,malware,coinminer
7844534412496946496,10.127.0.162,109.98.58.98,80,tcp,http,8382,16583,113,18316,150,34899,263,malware,coinminer
366763602133381036,10.127.0.162,190.211.254.211,80,tcp,http,65370,318934,325,5636,119,324570,444,malware,coinminer
7199625754580673562,10.127.0.162,51.91.79.17,443,tcp,tls,311,4904,7,767,7,5671,14,malware,coinminer
912283464443592463,10.127.0.162,80.66.64.210,80,tcp,http,11609,35649,724,1919164,1402,1954813,2126,malware,coinminer
4880554038655367929,10.127.0.162,172.67.75.172,443,tcp,tls,8717,3892,8,710,8,4602,16,malware,coinminer
-5149963876500281222,10.127.0.2,8.8.8.8,53,udp,dns,28,77,1,61,1,138,2,normal,-
3038789251390028151,10.127.0.2,162.19.139.184,12222,tcp,tls,82749,8638,17,1550,13,10188,30,malware,coinminer
2194939322036528663,10.127.0.140,8.8.8.8,53,udp,dns,18,191,2,127,2,318,4,normal,-
-461992635454081808,10.127.0.140,45.76.89.70,80,tcp,tls,104282,12580,27,2890,20,15470,47,malware,coinminer
-5794398550494331877,10.127.0.140,172.67.149.91,443,tcp,tls,1954,6836,15,1102,12,7938,27,malware,coinminer
946612225247996581,10.127.0.191,192.229.221.95,80,tcp,-,2,80,2,92,2,172,4,malware,coinminer
8100881648668281193,10.127.0.191,37.140.192.25,443,tcp,tls,90901,96565,89,3734,62,100299,151,malware,coinminer
3309009662321475360,10.127.0.191,88.221.25.169,80,tcp,http,60127,1671,5,416,6,2087,11,malware,coinminer
-200327215209697943,10.127.0.69,52.152.108.96,443,tcp,-,45129,0,0,780,15,780,15,malware,coinminer
3251480300981847015,10.127.0.69,179.43.140.229,80,tcp,http,18022,5553164,4012,272615,2328,5825779,6340,malware,coinminer
-6819002463595702675,10.127.0.183,40.126.32.74,443,tcp,-,15003,0,0,260,5,260,5,malware,coinminer
-1909542621413154303,10.127.0.183,104.208.16.90,443,tcp,-,37905,0,0,644,14,644,14,malware,coinminer
265131016255201384,10.127.0.183,204.79.197.203,80,tcp,-,37907,0,0,644,14,644,14,malware,coinminer
-3162396075513511221,10.127.0.183,84.53.175.11,80,tcp,-,53395,0,0,904,19,904,19,malware,coinminer
6598035817048952970,10.127.0.183,185.17.0.22,44810,tcp,-,1582,1032,8,546,9,1578,17,malware,coinminer
-938452475709662018,10.127.0.183,45.15.159.181,80,tcp,http,11241,2488083,1872,53963,1043,2542046,2915,malware,coinminer
-7747350679470704772,10.127.0.183,162.19.139.184,2222,tcp,-,15166,585,4,801,5,1386,9,malware,coinminer
5638988688720453928,10.127.0.221,20.112.52.29,80,tcp,-,302,92,2,190,4,282,6,normal,-
-8176960044610891533,10.127.0.221,40.93.207.7,25,tcp,-,10200,0,0,152,3,152,3,malware,coinminer
7732066890847430606,10.127.0.221,67.195.228.106,25,tcp,-,9856,0,0,152,3,152,3,malware,coinminer
-1524792437667803929,10.127.0.221,80.66.75.254,443,tcp,-,10469,582,6,507,8,1089,14,malware,coinminer
-1811593652218245546,10.127.0.221,142.250.102.27,25,tcp,-,10201,0,0,152,3,152,3,malware,coinminer
-6178102770390911964,10.127.0.221,217.69.139.150,25,tcp,-,9745,0,0,152,3,152,3,malware,coinminer
-7194985355486898957,10.127.0.221,80.66.75.254,484,tcp,-,3108,569905,421,10326,217,580231,638,malware,coinminer
-1319166845049654160,10.127.0.221,213.91.128.133,10060,tcp,-,14225,1820,6,558,5,2378,11,malware,coinminer
258129938308971812,10.127.0.221,176.113.115.239,428,tcp,-,44764,1731,14,3381,10,5112,24,malware,coinminer
5673140791880137780,10.127.0.221,176.113.115.154,428,tcp,-,22114,1351,7,388,7,1739,14,malware,coinminer
-8812705623016808095,10.127.0.221,176.113.115.155,428,tcp,-,44551,1731,14,3664,11,5395,25,malware,coinminer
-6166976793894562299,10.127.0.221,80.66.75.4,428,tcp,-,45434,1731,14,3380,10,5111,24,malware,coinminer
5650691648257927769,10.127.0.221,176.113.115.135,428,tcp,-,45380,1731,14,3380,10,5111,24,malware,coinminer
-4047340699884745046,10.127.0.221,176.113.115.136,428,tcp,-,44677,1731,14,3379,10,5110,24,malware,coinminer
6372472584565370164,10.127.0.221,142.251.39.100,80,tcp,http,11469,15489,30,3367,33,18856,63,normal,-
8277479355156667824,10.127.0.201,95.179.241.203,80,tcp,tls,98169,14469,33,3357,24,17826,57,malware,coinminer
9130898324195927787,10.127.0.201,104.21.41.183,443,tcp,tls,2028,6798,14,1056,11,7854,25,malware,coinminer
-7355902766779337127,10.127.0.54,104.21.83.128,443,tcp,http,100218,5973,10,804,10,6777,20,malware,coinminer
-5375197075865067851,10.127.0.54,172.67.149.91,443,tcp,http,212715,5524187,4340,977073,2606,6501260,6946,malware,coinminer
4234650207013633745,10.127.0.54,45.35.72.106,443,tcp,http,103140,5117,9,910,10,6027,19,malware,coinminer
4909745881116751166,10.127.0.54,20.207.73.82,443,tcp,http,101867,6119,12,929,12,7048,24,normal,-
6098220728317539793,10.127.0.54,185.199.108.133,443,tcp,http,100605,2088698,1503,35180,754,2123878,2257,malware,coinminer
-42791160824817782,10.127.0.54,45.76.89.70,80,tcp,tls,79281,9304,25,3899,25,13203,50,malware,coinminer
-963582644615473043,10.127.0.54,104.21.41.183,443,tcp,tls,182,6800,14,1056,11,7856,25,malware,coinminer
-7321751723122981835,10.127.0.53,109.206.243.140,80,tcp,http,69586,171737,178,14304,164,186041,342,malware,coinminer
-181988481436347942,10.127.0.11,20.112.52.29,80,tcp,-,342,132,3,190,4,322,7,normal,-
-1763507162858519629,10.127.0.11,104.47.53.36,25,tcp,-,9929,0,0,152,3,152,3,malware,coinminer
-6425680020815275603,10.127.0.11,67.195.228.111,25,tcp,-,10135,0,0,152,3,152,3,malware,coinminer
6628804905211098460,10.127.0.11,80.66.75.254,443,tcp,https,384,582,6,355,5,937,11,malware,coinminer
-3282706799762397877,10.127.0.11,142.250.102.27,25,tcp,-,9955,0,0,152,3,152,3,malware,coinminer
-5385809936157275346,10.127.0.11,80.66.75.254,486,tcp,-,3682,570976,439,13128,235,584104,674,malware,coinminer
1826276883005033675,10.127.0.11,176.113.115.239,422,tcp,-,75207,2021,20,5040,15,7061,35,malware,coinminer
-1984389406589631782,10.127.0.11,176.113.115.154,422,tcp,-,75078,2828,28,6786,22,9614,50,malware,coinminer
644290437399519385,10.127.0.11,176.113.115.155,422,tcp,-,74976,2086,21,5046,15,7132,36,malware,coinminer
7196096809306229223,10.127.0.11,80.66.75.4,422,tcp,-,75841,2122,21,7846,17,9968,38,malware,coinminer
2391518832772526335,10.127.0.11,176.113.115.135,422,tcp,-,74806,2122,21,6446,16,8568,37,malware,coinminer
-6877551138173051311,10.127.0.11,176.113.115.136,422,tcp,-,79858,31779,177,123049,188,154828,365,malware,coinminer
-6494533874226288531,10.127.0.11,142.251.39.100,80,tcp,http,3520,18415,37,3956,38,22371,75,normal,-
-7600722557563345706,10.127.0.11,217.69.139.150,25,tcp,-,10165,0,0,152,3,152,3,malware,coinminer
3417750942782829969,10.127.0.11,213.91.128.133,10060,tcp,-,418,1413,5,552,5,1965,10,malware,coinminer
6826104564593016930,10.127.0.11,157.240.221.63,443,tcp,tls,13491,26992,43,8850,34,35842,77,malware,coinminer
-412071422217537232,10.127.0.11,87.98.250.141,993,tcp,-,9246,0,0,152,3,152,3,malware,coinminer
-885530915461855595,10.127.0.11,20.44.209.209,443,tcp,tls,8758,28892,51,4910,38,33802,89,malware,coinminer
-1771302239300839765,10.127.0.11,104.244.42.130,443,tcp,tls,5026,40563,62,9734,47,50297,109,malware,coinminer
-4633192042445540144,10.127.0.11,210.157.5.10,587,tcp,-,3625,4530,14,1426,12,5956,26,malware,coinminer
8463560578413237359,10.127.0.11,157.240.196.63,443,tcp,tls,1860,16497,21,2504,16,19001,37,malware,coinminer
-1526620244058816665,10.127.0.73,20.207.73.82,443,tcp,http,104337,12134,22,1815,23,13949,45,normal,-
7994490198690423076,10.127.0.73,185.199.108.133,443,tcp,http,101587,978899,714,17283,358,996182,1072,malware,coinminer
-1219220625286567137,10.127.0.73,172.67.175.222,443,tcp,http,100116,5975,10,804,10,6779,20,malware,coinminer
4074578192973133146,10.127.0.73,104.21.41.183,443,tcp,http,212148,5107900,3919,547558,2087,5655458,6006,malware,coinminer
8704779405347526496,10.127.0.73,45.35.72.106,443,tcp,http,103059,6345,10,956,11,7301,21,malware,coinminer
-522507233717790448,10.127.0.73,20.189.173.2,443,tcp,-,75828,0,0,1288,28,1288,28,malware,coinminer
3698614961502686941,10.127.0.73,95.179.241.203,80,tcp,tls,78749,9547,23,3219,22,12766,45,malware,coinminer
-7339393640366788325,10.127.0.73,172.67.149.91,443,tcp,tls,185,6792,14,1056,11,7848,25,malware,coinminer
-5468887040798941088,10.127.0.73,13.107.4.50,80,tcp,-,76012,0,0,1288,28,1288,28,malware,coinminer
4628665456995529612,10.127.0.126,93.184.221.240,80,tcp,-,185570,0,0,3158,68,3158,68,malware,coinminer
-5095028345332657701,10.127.0.126,179.43.140.229,80,tcp,http,6255,5551004,4023,343842,2774,5894846,6797,malware,coinminer
4185460034260307235,10.127.0.126,141.94.96.195,5555,tcp,-,98558,5270,13,1204,14,6474,27,malware,coinminer
4897538672791323830,10.127.0.126,204.79.197.203,80,tcp,-,57013,0,0,966,21,966,21,malware,coinminer
2906943612374012355,10.127.0.69,20.224.151.203,443,tcp,-,0,40,1,0,0,40,1,malware,coinminer
-4141090557180249758,10.127.0.69,109.206.243.140,80,tcp,http,65893,184201,283,31676,303,215877,586,malware,coinminer
3095139248458062381,10.127.0.69,20.207.73.82,443,tcp,http,98543,450823,335,12178,221,463001,556,normal,-
2012625130536590533,10.127.0.69,157.254.195.116,80,tcp,-,15049,0,0,260,5,260,5,malware,coinminer
-8761748468595399459,10.127.0.69,185.47.40.36,443,tcp,http,30278,6245,14,998,11,7243,25,malware,coinminer
5901871242484889757,10.127.0.69,87.238.33.8,443,tcp,http,2446,2787302,2002,49171,1038,2836473,3040,malware,coinminer
4416887509654685266,10.127.0.69,104.192.141.1,443,tcp,http,3887,10212,15,1233,11,11445,26,malware,coinminer
8602335775091181550,10.127.0.69,3.5.28.191,443,tcp,http,9629,1531359,1109,27996,562,1559355,1671,malware,coinminer
2479886581108037405,10.127.0.69,164.132.200.171,15555,tcp,-,15019,0,0,260,5,260,5,malware,coinminer
-2143303167270911904,10.127.0.69,144.76.136.153,443,tcp,tls,6997,1553776,1122,29711,597,1583487,1719,malware,coinminer
4072157573210088948,10.127.0.69,185.199.108.153,443,tcp,tls,17,105459,81,2492,44,107951,125,malware,coinminer
3345787977235751426,10.127.0.69,51.81.126.50,48524,tcp,-,14693,19220,293,1562935,1073,1582155,1366,malware,coinminer
-2113957228344015933,10.127.0.69,51.91.79.17,443,tcp,tls,325,4905,7,767,7,5672,14,malware,coinminer
2400341633362404179,10.127.0.75,185.246.221.154,80,tcp,http,223,362,4,837,6,1199,10,malware,coinminer
-4013643335549952773,10.127.0.29,8.8.8.8,53,udp,dns,101,323,4,227,4,550,8,normal,-
-3151003753175101236,10.127.0.29,104.21.83.128,443,tcp,http,101119,6678,12,853,11,7531,23,malware,coinminer
-589009374740891842,10.127.0.29,104.21.41.183,443,tcp,http,212132,10341236,7777,626069,4659,10967305,12436,malware,coinminer
4041191837633501508,10.127.0.29,45.35.72.106,443,tcp,http,105646,9184,13,1116,15,10300,28,malware,coinminer
-5303716098142902699,10.127.0.29,20.207.73.82,443,tcp,tls,1178,179,4,344,5,523,9,normal,-
7284055081376812058,10.127.0.122,52.109.13.64,443,tcp,-,0,40,1,0,0,40,1,malware,coinminer
4253066641608544226,10.127.0.115,193.56.146.218,80,tcp,-,44230,95170,76,2420,44,97590,120,malware,coinminer
4140129470211344143,10.127.0.115,20.112.52.29,80,tcp,-,378,132,3,190,4,322,7,normal,-
-4413606322156205140,10.127.0.115,104.47.53.36,25,tcp,-,9592,0,0,152,3,152,3,malware,coinminer
2414158688104487697,10.127.0.115,98.136.96.91,25,tcp,-,9836,0,0,152,3,152,3,malware,coinminer
3135885918828004157,10.127.0.115,80.66.75.254,443,tcp,https,441,582,6,355,5,937,11,malware,coinminer
5379465910219952358,10.127.0.115,142.250.102.26,25,tcp,-,9689,0,0,152,3,152,3,malware,coinminer
-8693844573996008742,10.127.0.115,80.66.75.254,484,tcp,-,4798,570936,438,13040,233,583976,671,malware,coinminer
1133010291425846147,10.127.0.115,94.100.180.31,25,tcp,-,10183,0,0,152,3,152,3,malware,coinminer
-9129578395920403590,10.127.0.115,176.113.115.239,428,tcp,-,63717,9984,100,139082,164,149066,264,malware,coinminer
4174281573371027995,10.127.0.115,176.113.115.154,428,tcp,-,74872,1916,18,6452,15,8368,33,malware,coinminer
-4103533906149281420,10.127.0.115,176.113.115.155,428,tcp,-,75494,1981,19,6454,15,8435,34,malware,coinminer
-7665836012403672084,10.127.0.115,80.66.75.4,428,tcp,-,77846,10810,76,51806,70,62616,146,malware,coinminer
291366394874214227,10.127.0.115,176.113.115.135,428,tcp,-,77637,71028,368,303500,397,374528,765,malware,coinminer
613337656611063040,10.127.0.115,176.113.115.136,428,tcp,-,75747,2021,20,6450,15,8471,35,malware,coinminer
4873613366056260379,10.127.0.115,142.251.39.100,80,tcp,http,3375,18298,36,3858,36,22156,72,normal,-
5185158831672098133,10.127.0.115,104.18.141.32,443,tcp,tls,2261,19185,30,3020,23,22205,53,malware,coinminer
5417647318432886313,10.127.0.115,157.240.221.63,443,tcp,tls,7836,39848,67,11250,54,51098,121,malware,coinminer
-6678492098433367702,10.127.0.115,213.91.128.133,10060,tcp,-,32172,956,4,546,5,1502,9,malware,coinminer
-8776807284829318026,10.127.0.115,20.44.209.209,443,tcp,tls,37826,102842,191,17553,142,120395,333,malware,coinminer
-7597153886446637189,10.127.0.115,104.244.42.66,443,tcp,tls,22308,186175,272,40152,194,226327,466,malware,coinminer
-4645665514798288152,10.127.0.115,23.72.252.138,443,tcp,tls,6155,120648,114,5654,66,126302,180,malware,coinminer
6626830797458666655,10.127.0.176,109.206.243.140,80,tcp,http,41788,188887,341,41062,367,229949,708,malware,coinminer
6938395442184211022,10.127.0.176,51.91.79.17,443,tcp,http,75269,5097,11,930,10,6027,21,malware,coinminer
-6576679067040818120,10.127.0.167,173.223.113.99,80,tcp,-,1,120,3,138,3,258,6,malware,coinminer
-2520695226542411825,10.127.0.167,95.179.241.203,80,tcp,tls,1417,3112,8,1336,8,4448,16,malware,coinminer
3984665288788003184,10.127.0.167,104.21.41.183,443,tcp,tls,344,6792,14,1056,11,7848,25,malware,coinminer
4905456772578658445,10.127.0.167,45.76.89.70,80,tcp,tls,98683,6803,14,1566,13,8369,27,malware,coinminer
-833903818815805554,10.127.0.75,109.206.243.140,80,tcp,http,23827,197636,383,49731,425,247367,808,malware,coinminer
-2345895418774511082,10.127.0.75,20.207.73.82,443,tcp,http,54288,449209,367,9466,191,458675,558,normal,-
2745952140940025269,10.127.0.75,157.254.195.116,80,tcp,-,15028,0,0,260,5,260,5,malware,coinminer
8593824960494228233,10.127.0.75,185.47.40.36,443,tcp,http,30278,6245,14,1044,12,7289,26,malware,coinminer
460836575252316294,10.127.0.75,87.238.33.8,443,tcp,http,4879,2804022,2012,60409,1241,2864431,3253,malware,coinminer
751857137073751874,10.127.0.75,104.192.141.1,443,tcp,http,81116,10252,16,1325,13,11577,29,malware,coinminer
-2073866720938988098,10.127.0.75,54.231.197.249,443,tcp,http,7866,1531863,1114,52666,799,1584529,1913,malware,coinminer
5787073319472481609,10.127.0.75,164.132.200.171,15555,tcp,-,15068,0,0,260,5,260,5,malware,coinminer
-3234473811890835828,10.127.0.75,144.76.136.153,443,tcp,http,48236,10049656,7255,186386,4013,10236042,11268,malware,coinminer
7914149342510913940,10.127.0.75,167.235.133.96,43849,tcp,-,9647,37422,795,2824540,1915,2861962,2710,malware,coinminer
-7039016681289356604,10.127.0.75,185.199.108.153,443,tcp,tls,44,105561,82,2452,43,108013,125,malware,coinminer
-3205127872963939857,10.127.0.75,51.91.79.17,443,tcp,tls,180,4905,7,767,7,5672,14,malware,coinminer
4437136515597104157,10.127.0.75,104.20.138.65,443,tcp,tls,551,5202,12,905,10,6107,22,malware,coinminer
5350188227724365222,10.127.0.75,31.14.70.247,443,tcp,tls,300,6714,8,940,8,7654,16,malware,coinminer
7209701393194572806,10.127.0.75,51.178.66.33,443,tcp,tls,336,23498,24,1226,15,24724,39,malware,coinminer
-694474168219621664,10.127.0.75,37.220.87.13,40676,tcp,-,11185,27303,584,2030673,1539,2057976,2123,malware,coinminer
3733780515987284324,10.127.0.75,185.106.92.128,17092,tcp,-,6963,31831,619,3265453,2376,3297284,2995,malware,coinminer
-7094314468424878719,10.127.0.75,146.70.106.55,80,tcp,http,50361,4691225,4354,202027,4355,4893252,8709,malware,coinminer
6652974715600195630,10.127.0.75,51.81.126.50,48524,tcp,-,23833,11824,153,549158,387,560982,540,malware,coinminer
662296477290745616,10.127.0.67,172.67.181.144,80,tcp,http,109954,3233621,2467,73929,1318,3307550,3785,malware,coinminer
1014176608649674693,10.127.0.67,203.91.116.53,80,tcp,http,17579,2290432,1729,57716,1227,2348148,2956,malware,coinminer
-8378867405639559880,10.127.0.67,45.9.74.80,80,tcp,http,75466,1477305,1060,44824,802,1522129,1862,malware,coinminer
6161405166758794687,10.127.0.67,20.42.65.89,443,tcp,-,57412,0,0,966,21,966,21,malware,coinminer
-7203360552054124118,10.127.0.67,79.137.206.226,80,tcp,http,5334,204232,157,7395,146,211627,303,malware,coinminer
7430711604434777398,10.127.0.67,162.0.217.254,443,tcp,tls,79619,41225,60,5448,78,46673,138,malware,coinminer
-446948370944575604,10.127.0.67,45.136.113.107,80,tcp,http,220645,3157950,3098,117820,2243,3275770,5341,malware,coinminer
-9217358734646641826,10.127.0.67,104.21.8.227,443,tcp,tls,71300,1330986,1170,30804,622,1361790,1792,malware,coinminer
-8721712681905082696,10.127.0.67,161.97.179.222,443,tcp,tls,65292,209531,160,4385,85,213916,245,malware,coinminer
-6940321245113226036,10.127.0.67,8.238.20.126,80,tcp,-,57071,0,0,966,21,966,21,malware,coinminer
-6313687958088590542,10.127.0.67,8.238.177.126,80,tcp,-,171645,0,0,2898,63,2898,63,malware,coinminer
-1730017059718221860,10.127.0.67,89.190.157.61,80,tcp,http,10263,278728,203,5061,106,283789,309,malware,coinminer
9020815612306421966,10.127.0.67,77.73.134.27,80,tcp,http,205098,1433182,6673,969027,21051,2402209,27724,malware,coinminer
5718594659121636512,10.127.0.67,109.206.243.140,80,tcp,http,19143,179124,250,27628,250,206752,500,malware,coinminer
-8743863659849456309,10.127.0.67,157.240.221.35,443,tcp,tls,101551,312176,246,13940,134,326116,380,normal,-
4688511458380052707,10.127.0.67,45.66.159.179,80,tcp,http,122517,2161,17,2902,22,5063,39,malware,coinminer
-156145740592569661,10.127.0.67,186.182.55.44,80,tcp,http,6267,21884,27,1705,30,23589,57,malware,coinminer
-4769318709855771140,10.127.0.67,109.98.58.98,80,tcp,http,2561,7339,51,8633,71,15972,122,malware,coinminer
-7848732137234968472,10.127.0.67,190.211.254.211,80,tcp,http,265,319414,337,5498,116,324912,453,malware,coinminer
1631801920862812751,10.127.0.67,51.91.79.17,443,tcp,tls,197,4906,7,767,7,5673,14,malware,coinminer
-6992269449760100563,10.127.0.118,20.54.89.15,443,tcp,tls,85410,0,0,6520,36,6520,36,malware,coinminer
4715719671725580173,10.127.0.118,8.8.8.8,53,udp,dns,18637,13816,95,7555,105,21371,200,normal,-
-7324551698713253815,10.127.0.118,209.197.3.8,80,tcp,-,151380,0,0,2588,53,2588,53,malware,coinminer
-2974643339240396162,10.127.0.118,179.43.140.229,80,tcp,http,20422,5569128,4052,377383,3125,5946511,7177,malware,coinminer
-7946204641811883971,10.127.0.118,51.15.69.136,14433,tcp,tls,100487,5443,12,1558,13,7001,25,malware,coinminer
-4746248600498255167,10.127.0.118,173.223.113.164,443,tcp,-,114338,0,0,1932,42,1932,42,malware,coinminer
-4920649089032901248,10.127.0.118,173.223.113.131,80,tcp,-,152356,0,0,2576,56,2576,56,malware,coinminer
1722190487272093452,10.127.0.118,131.253.33.203,80,tcp,-,76216,0,0,1288,28,1288,28,malware,coinminer
2978708772622798329,10.127.0.125,179.43.140.229,80,tcp,http,6844,5551676,4042,265501,2372,5817177,6414,malware,coinminer
1686665912836108530,10.127.0.125,51.15.58.224,14433,tcp,tls,84678,7584,17,1547,12,9131,29,malware,coinminer
-291894377266161993,10.127.0.177,179.43.140.229,80,tcp,http,24205,6465404,4684,392265,3589,6857669,8273,malware,coinminer
8623832244592361751,10.127.0.177,51.255.34.118,14433,tcp,tls,90772,5022,11,1512,12,6534,23,malware,coinminer
-3222115696913852874,10.127.0.215,92.204.173.86,80,tcp,-,54338,0,0,864,17,864,17,malware,coinminer
7284745492561709193,10.127.0.191,152.195.38.76,80,tcp,-,2,80,2,92,2,172,4,malware,coinminer
-6989841454975244227,10.127.0.191,185.215.113.66,80,tcp,http,55975,48332,46,4196,68,52528,114,malware,coinminer
-5943626219134954337,10.127.0.191,20.72.235.82,80,tcp,-,375,92,2,144,3,236,5,malware,coinminer
-3084533532251561946,10.127.0.191,77.93.33.36,40500,udp,-,0,0,0,64,1,64,1,malware,coinminer
-494993514974038151,10.127.0.191,178.75.85.60,40500,tcp,-,14996,0,0,260,5,260,5,malware,coinminer
-5521156039997890316,10.127.0.191,109.187.89.230,40500,udp,-,0,0,0,64,1,64,1,malware,coinminer
-2953815808896082875,10.127.0.191,176.194.0.190,40500,udp,-,0,0,0,64,1,64,1,malware,coinminer
-3383699252163008253,10.127.0.191,94.141.76.251,40500,udp,-,90248,0,0,128,2,128,2,malware,coinminer
-6470747684260290514,10.127.0.191,176.113.142.128,40500,udp,-,0,0,0,64,1,64,1,malware,coinminer
2938212925367864888,10.127.0.191,5.233.208.228,40500,udp,-,0,0,0,64,1,64,1,malware,coinminer
1949427058278764856,10.127.0.191,5.232.180.190,40500,tcp,-,15054,0,0,260,5,260,5,malware,coinminer
889451154448105648,10.127.0.191,178.155.43.150,40500,udp,-,0,0,0,64,1,64,1,malware,coinminer
-4374463608135787581,10.127.0.191,187.228.142.235,40500,udp,-,0,0,0,64,1,64,1,malware,coinminer
7157183871392321546,10.127.0.191,2.179.37.108,40500,udp,-,0,0,0,64,1,64,1,malware,coinminer
-4720974963088852424,10.127.0.191,151.241.206.116,40500,udp,-,0,0,0,64,1,64,1,malware,coinminer
1089177317625780946,10.127.0.191,213.230.127.140,40500,udp,-,0,0,0,64,1,64,1,malware,coinminer
8501223653900439735,10.127.0.191,87.76.44.236,40500,tcp,-,15026,0,0,260,5,260,5,malware,coinminer
-7459659508862757877,10.127.0.191,154.71.239.26,40500,udp,-,10029,0,0,128,2,128,2,malware,coinminer
-8058860813848686679,10.127.0.191,192.168.1.7,40500,udp,-,0,0,0,64,1,64,1,malware,coinminer
2621603806826987524,10.127.0.191,89.42.98.4,40500,udp,-,0,0,0,64,1,64,1,malware,coinminer
4648274955803588554,10.127.0.191,77.104.95.241,40500,udp,-,0,0,0,64,1,64,1,malware,coinminer
-6165481969113461011,10.127.0.191,42.115.225.207,40500,tcp,-,14444,1630,12,1006,15,2636,27,malware,coinminer
9125547818905600513,10.127.0.191,31.59.46.152,40500,udp,-,0,0,0,64,1,64,1,malware,coinminer
-3887709351293577520,10.127.0.191,217.30.160.236,40500,udp,-,0,0,0,64,1,64,1,malware,coinminer
-1437804413334347779,10.127.0.191,192.168.1.14,40500,udp,-,0,0,0,64,1,64,1,malware,coinminer
3141328435659879488,10.127.0.191,189.154.162.148,40500,udp,-,0,0,0,64,1,64,1,malware,coinminer
6802423669659345542,10.127.0.191,2.185.152.73,40500,tcp,-,15014,0,0,260,5,260,5,malware,coinminer
-8621358527326679508,10.127.0.191,197.148.89.90,40500,udp,-,0,0,0,64,1,64,1,malware,coinminer
-6274231538235678541,10.127.0.191,185.215.113.84,80,tcp,http,4734,2135513,1528,76102,1530,2211615,3058,malware,coinminer
1341072299270245759,10.127.0.191,46.225.101.157,40500,udp,-,0,0,0,64,1,64,1,malware,coinminer
-8195402947510827963,10.127.0.191,5.236.166.20,40500,udp,-,0,0,0,64,1,64,1,malware,coinminer
7014244061650163100,10.127.0.191,192.168.1.45,40500,udp,-,0,0,0,64,1,64,1,malware,coinminer
-9213362390809970286,10.127.0.191,217.30.170.150,40500,tcp,-,1134,776,6,878,8,1654,14,malware,coinminer
-5791454104695235168,10.127.0.191,31.58.98.38,40500,udp,-,0,0,0,64,1,64,1,malware,coinminer
-5081638236810568816,10.127.0.191,185.215.113.84,5151,tcp,-,204,597,3,764,4,1361,7,malware,coinminer
4820196450777234232,10.127.0.61,40.93.207.1,25,tcp,-,12016,0,0,156,3,156,3,malware,coinminer
-1157272112507423913,10.127.0.61,20.112.52.29,80,tcp,-,-1,0,0,0,0,0,0,malware,coinminer
-1730824064619479485,10.127.0.61,67.195.228.111,25,tcp,-,15058,0,0,260,5,260,5,malware,coinminer
3079661546179013021,10.127.0.61,80.66.75.254,443,tcp,https,319,582,6,355,5,937,11,malware,coinminer
-6077473247503733569,10.127.0.61,142.250.102.26,25,tcp,-,15070,0,0,260,5,260,5,malware,coinminer
2480414685503346616,10.127.0.61,80.66.75.254,487,tcp,-,2368,571056,441,12946,231,584002,672,malware,coinminer
2442467311711753998,10.127.0.61,213.91.128.133,10060,tcp,-,67136,1067,5,714,7,1781,12,malware,coinminer
7314478821150027865,10.127.0.61,176.113.115.239,431,tcp,-,82603,13406,118,118812,124,132218,242,malware,coinminer
3503812531555362408,10.127.0.61,176.113.115.154,431,tcp,-,74766,1419,16,3498,12,4917,28,malware,coinminer
-5263400935702992789,10.127.0.61,176.113.115.155,431,tcp,-,85831,17689,110,73695,109,91384,219,malware,coinminer
-2666165466952465582,10.127.0.61,80.66.75.4,431,tcp,-,75318,1419,16,3497,12,4916,28,malware,coinminer
2149145573109697823,10.127.0.61,176.113.115.135,431,tcp,-,75247,1419,16,3498,12,4917,28,malware,coinminer
-8435378488662913946,10.127.0.61,176.113.115.136,431,tcp,-,74645,15627,91,63207,89,78834,180,malware,coinminer
5246351370604364412,10.127.0.61,142.251.39.100,80,tcp,http,1880,18291,36,3904,37,22195,73,normal,-
-4889221204200022924,10.127.0.61,69.192.67.3,443,tcp,tls,854,22474,33,2896,22,25370,55,normal,-
4518603118698486385,10.127.0.61,157.240.221.63,443,tcp,tls,6043,44353,67,11402,51,55755,118,malware,coinminer
-6812063196943410606,10.127.0.61,94.100.180.31,25,tcp,-,15354,0,0,260,5,260,5,malware,coinminer
1487830085121862674,10.127.0.61,157.240.196.174,443,tcp,tls,3300,85060,78,3109,44,88169,122,normal,-
22233207531429337,10.127.0.61,104.23.143.25,443,tcp,tls,9022,3631,9,1337,9,4968,18,malware,coinminer
7493780404271179959,10.127.0.61,104.23.142.25,443,tcp,tls,8378,8421,14,1378,12,9799,26,malware,coinminer
8986533106989542328,10.127.0.61,104.23.141.25,443,tcp,tls,3676,3763,8,1429,9,5192,17,malware,coinminer
8777514803454609854,10.127.0.61,104.18.140.32,443,tcp,tls,629,9658,16,1654,14,11312,30,malware,coinminer
-3558319152060870846,10.127.0.61,37.1.217.172,25000,tcp,http,19,612,6,530,6,1142,12,malware,coinminer
-1860814546532931566,10.127.0.61,20.44.209.209,443,tcp,tls,6820,22237,43,4411,38,26648,81,malware,coinminer
-121850832544752849,10.127.0.61,104.244.42.194,443,tcp,tls,3551,43806,66,9811,47,53617,113,malware,coinminer
-2575818300498842543,10.127.0.174,109.206.243.140,80,tcp,-,93437,172333,184,15858,180,188191,364,malware,coinminer
-1159104091567049981,10.127.0.182,40.126.32.134,443,tcp,-,15112,0,0,260,5,260,5,malware,coinminer
-2806546707825395403,10.127.0.182,37.140.192.25,443,tcp,-,15040,0,0,260,5,260,5,malware,coinminer
-3478528212520278489,10.127.0.139,193.233.20.28,4125,tcp,-,9585,9270,47,68909,71,78179,118,malware,redlinestealer
-1564347373806826142,10.127.0.139,193.56.146.220,4174,tcp,-,18932,17490,89,137559,138,155049,227,malware,redlinestealer
-6098235387764981501,10.127.0.110,193.233.20.28,4125,tcp,-,9776,11097,123,302629,250,313726,373,malware,redlinestealer
7216660236023165637,10.127.0.110,193.56.146.220,4174,tcp,-,34016,56151,906,3324084,2482,3380235,3388,malware,redlinestealer
-6032246920758279722,10.127.0.110,20.50.201.200,443,tcp,-,56858,0,0,966,21,966,21,malware,redlinestealer
8367159051648001413,10.127.0.110,117.18.237.29,80,tcp,-,178767,0,0,1486,31,1486,31,malware,redlinestealer
-2361435160566001618,10.127.0.64,93.184.220.29,80,tcp,-,75755,0,0,1288,28,1288,28,malware,redlinestealer
-220522522572927113,10.127.0.64,193.56.146.220,4174,tcp,-,36033,93946,1888,6625459,4526,6719405,6414,malware,redlinestealer
378071131226346499,10.127.0.64,31.41.244.200,80,tcp,http,329911,1456,16,1621,19,3077,35,malware,redlinestealer
-5188587691845974028,10.127.0.64,20.189.173.12,443,tcp,-,75806,0,0,1288,28,1288,28,malware,redlinestealer
6000630571164972651,10.127.0.64,8.238.20.126,80,tcp,-,75889,0,0,1288,28,1288,28,malware,redlinestealer
6262093196959291613,10.127.0.64,131.253.33.203,80,tcp,-,75811,0,0,1288,28,1288,28,malware,redlinestealer
-6469671529983293847,10.127.0.124,193.233.20.28,4125,tcp,-,21647,75411,1542,4911829,3616,4987240,5158,malware,redlinestealer
-2302030659049387671,10.127.0.124,193.56.146.220,4174,tcp,-,33819,105121,2127,8158522,5997,8263643,8124,malware,redlinestealer
-7270095828322434586,10.127.0.124,20.189.173.12,443,tcp,-,57452,0,0,966,21,966,21,malware,redlinestealer
6764465250166541115,10.127.0.124,8.238.177.126,80,tcp,-,113710,0,0,1932,42,1932,42,malware,redlinestealer
3265411144799132623,10.127.0.73,80.66.64.210,80,tcp,http,6944,45689,975,3320802,2229,3366491,3204,malware,redlinestealer
3700586442921935731,10.127.0.73,104.26.12.31,443,tcp,http,5518,3885,8,710,8,4595,16,malware,redlinestealer
-3371870193760721746,10.127.0.176,37.220.87.8,42823,tcp,-,5225,53101,1144,4098581,3101,4151682,4245,malware,redlinestealer
7467015262025017299,10.127.0.142,193.233.20.28,4125,tcp,-,9653,23951,411,1157911,846,1181862,1257,malware,redlinestealer
1492346985018204029,10.127.0.142,193.56.146.220,4174,tcp,-,19912,37782,593,2316119,1593,2353901,2186,malware,redlinestealer
5020098287473276501,10.127.0.111,94.140.115.7,80,tcp,-,28137,41433,866,2453136,1817,2494569,2683,malware,redlinestealer
-7062495772495362376,10.127.0.111,104.26.13.31,443,tcp,http,7286,3848,7,756,9,4604,16,malware,redlinestealer
5336845914444830869,10.127.0.111,40.77.2.164,443,tcp,-,14989,0,0,260,5,260,5,malware,redlinestealer
4524566538520780223,10.127.0.177,193.56.146.220,4174,tcp,-,38330,86959,1663,6561672,4856,6648631,6519,malware,redlinestealer
1662808750729105413,10.127.0.177,31.41.244.200,80,tcp,http,109934,407,5,523,6,930,11,malware,redlinestealer
-1684373604056106383,10.127.0.117,193.56.146.220,4174,tcp,-,47155,112820,2237,8961559,6452,9074379,8689,malware,redlinestealer
2499897896787075632,10.127.0.117,31.41.244.200,80,tcp,-,205605,1806,15,1598,18,3404,33,malware,redlinestealer
-1744277622067537361,10.127.0.145,193.233.20.28,4125,tcp,-,9317,17258,268,729811,541,747069,809,malware,redlinestealer
3681768886000344160,10.127.0.145,193.56.146.220,4174,tcp,-,9155,15492,227,728372,508,743864,735,malware,redlinestealer
8753259831215858955,10.127.0.110,31.41.244.200,80,tcp,http,219922,814,10,1046,12,1860,22,malware,redlinestealer
-5310505343236443302,10.127.0.116,185.106.92.128,17092,tcp,-,7491,74311,1678,6408383,4662,6482694,6340,malware,redlinestealer
-8911984779600291299,10.127.0.75,193.233.20.28,4125,tcp,-,9918,52382,1156,3729707,2684,3782089,3840,malware,redlinestealer
8752774866800505378,10.127.0.75,193.56.146.220,4174,tcp,-,32903,127123,2705,9870723,6687,9997846,9392,malware,redlinestealer
-5988090930137074806,10.127.0.122,94.140.115.7,80,tcp,-,28102,23599,431,1128205,854,1151804,1285,malware,redlinestealer
805021460800933102,10.127.0.122,104.26.13.31,443,tcp,http,7146,3888,8,756,9,4644,17,malware,redlinestealer
4880021831371080842,10.127.0.219,193.56.146.220,4174,tcp,-,68260,168748,3442,15363392,10369,15532140,13811,malware,redlinestealer
-7237553390731374460,10.127.0.219,31.41.244.200,80,tcp,http,260367,2408,20,1928,20,4336,40,malware,redlinestealer
-6665346829559191141,10.127.0.189,193.56.146.220,4174,tcp,-,27683,60154,1131,4142303,2954,4202457,4085,malware,redlinestealer
-8714425081410406226,10.127.0.189,31.41.244.200,80,tcp,http,175051,774,9,1000,11,1774,20,malware,redlinestealer
4180731086858419634,10.127.0.216,193.56.146.220,4174,tcp,-,10989,10799,78,210987,165,221786,243,malware,redlinestealer
2131652835007204549,10.127.0.216,31.41.244.200,80,tcp,http,65092,602,5,482,5,1084,10,malware,redlinestealer
1462519404879513373,10.127.0.75,31.41.244.200,80,tcp,http,219874,814,10,1046,12,1860,22,malware,redlinestealer
-8302330110101410159,10.127.0.12,193.56.146.220,4174,tcp,-,21482,33502,673,2290406,1688,2323908,2361,malware,redlinestealer
8169147889446405601,10.127.0.12,31.41.244.200,80,tcp,http,65125,602,5,482,5,1084,10,malware,redlinestealer
-8539688280484659928,10.127.0.52,193.56.146.220,4174,tcp,-,11697,36382,756,2684014,1825,2720396,2581,malware,redlinestealer
9190195356197131177,10.127.0.52,31.41.244.200,80,tcp,http,109875,407,5,523,6,930,11,malware,redlinestealer
-5584638486294558724,10.127.0.52,52.182.141.63,443,tcp,-,37903,0,0,644,14,644,14,malware,redlinestealer
-1294248270200976091,10.127.0.52,117.18.232.240,80,tcp,-,93212,0,0,1104,24,1104,24,malware,redlinestealer
-8263081642837541448,10.127.0.14,185.11.61.125,22344,tcp,-,4079,7155,12,8551,15,15706,27,malware,redlinestealer
6313857756885592006,10.127.0.187,185.11.61.125,22344,tcp,-,5646,7283,14,10863,18,18146,32,malware,redlinestealer
5400869912970190458,10.127.0.119,193.56.146.220,4174,tcp,-,24131,80038,1552,5061356,3723,5141394,5275,malware,redlinestealer
-6716705309132264844,10.127.0.119,31.41.244.200,80,tcp,http,175146,1009,10,1005,11,2014,21,malware,redlinestealer
908268577071854811,10.127.0.101,193.56.146.220,4174,tcp,-,11847,40683,843,2925815,2153,2966498,2996,malware,redlinestealer
5018727900225557597,10.127.0.101,31.41.244.200,80,tcp,http,109902,407,5,523,6,930,11,malware,redlinestealer
-174450539094730718,10.127.0.184,193.56.146.220,4174,tcp,-,23420,72715,1490,5137941,3779,5210656,5269,malware,redlinestealer
-7160801091875205927,10.127.0.184,193.56.146.218,80,tcp,http,109111,95170,76,2420,44,97590,120,malware,redlinestealer
9209831645181467225,10.127.0.200,8.8.8.8,53,udp,dns,101,224,2,118,2,342,4,normal,-
-6561202754040753168,10.127.0.200,80.66.64.60,80,tcp,http,22187,101481,2352,7763509,5197,7864990,7549,malware,redlinestealer
5827695210106707139,10.127.0.200,104.26.13.31,443,tcp,http,10571,5356,11,808,10,6164,21,malware,redlinestealer
-9158782615244493402,10.127.0.118,193.56.146.220,4174,tcp,-,21044,44865,743,2506030,1833,2550895,2576,malware,redlinestealer
-8560188961445219790,10.127.0.118,31.41.244.200,80,tcp,http,224000,1049,11,1051,12,2100,23,malware,redlinestealer
-4397674202956710149,10.127.0.187,193.56.146.220,4174,tcp,-,37476,68825,1173,4123126,3076,4191951,4249,malware,redlinestealer
8982345411112431417,10.127.0.187,31.41.244.200,80,tcp,http,334015,1456,16,1574,18,3030,34,malware,redlinestealer
3938137446423692816,10.127.0.193,193.56.146.220,4174,tcp,-,18504,30172,594,2231350,1644,2261522,2238,malware,redlinestealer
8935088483207334556,10.127.0.193,31.41.244.200,80,tcp,http,65128,602,5,482,5,1084,10,malware,redlinestealer
1671835813734774093,10.127.0.168,193.56.146.220,4174,tcp,-,38547,79132,1638,5958335,4293,6037467,5931,malware,redlinestealer
8782365312051200961,10.127.0.168,193.56.146.218,80,tcp,http,165179,189830,149,7728,151,197558,300,malware,redlinestealer
-7261197722971247315,10.127.0.3,193.56.146.220,4174,tcp,-,11207,17191,245,822725,619,839916,864,malware,redlinestealer
-932028871364151001,10.127.0.3,31.41.244.200,80,tcp,http,65125,602,5,482,5,1084,10,malware,redlinestealer
-2577150292235105704,10.127.0.107,193.233.20.28,4125,tcp,-,9411,8138,49,71762,80,79900,129,malware,redlinestealer
1039222663440507485,10.127.0.107,193.56.146.220,4174,tcp,-,20284,28858,380,1392189,1058,1421047,1438,malware,redlinestealer
797709529741657986,10.127.0.173,193.56.146.220,4174,tcp,-,13892,15030,218,721866,560,736896,778,malware,redlinestealer
-8223585833054934695,10.127.0.173,31.41.244.200,80,tcp,http,109966,407,5,523,6,930,11,malware,redlinestealer
7287167409060494401,10.127.0.14,193.56.146.220,4174,tcp,-,32679,76926,1301,4390402,3253,4467328,4554,malware,redlinestealer
-4401445435844865732,10.127.0.14,31.41.244.200,80,tcp,http,130238,1204,10,964,10,2168,20,malware,redlinestealer
1650209463771083630,10.127.0.141,193.233.20.28,4125,tcp,-,20179,76915,1735,5283007,3785,5359922,5520,malware,redlinestealer
-4324458813235729640,10.127.0.141,193.56.146.220,4174,tcp,-,11348,63151,1422,5273276,3546,5336427,4968,malware,redlinestealer
8055396785198504415,10.127.0.30,193.56.146.220,4174,tcp,-,12551,23894,404,1385077,1032,1408971,1436,malware,redlinestealer
765141323277512410,10.127.0.30,31.41.244.200,80,tcp,http,65132,602,5,482,5,1084,10,malware,redlinestealer
-7341786240906013710,10.127.0.164,193.56.146.220,4174,tcp,-,11651,19220,327,1086238,816,1105458,1143,malware,redlinestealer
-1012617389298917396,10.127.0.164,31.41.244.200,80,tcp,http,109968,407,5,523,6,930,11,malware,redlinestealer
-3243554097041315433,10.127.0.128,193.56.146.220,4174,tcp,-,11896,27374,494,2024899,1490,2052273,1984,malware,redlinestealer
7912934514747244178,10.127.0.128,31.41.244.200,80,tcp,http,114050,642,6,528,6,1170,12,malware,redlinestealer
-1787971683177040252,10.127.0.177,193.233.20.28,4125,tcp,-,10872,30701,614,2002848,1483,2033549,2097,malware,redlinestealer
2258492212566842905,10.127.0.21,193.56.146.220,4174,tcp,-,12109,43389,900,2992386,2194,3035775,3094,malware,redlinestealer
-7605622977315158568,10.127.0.21,31.41.244.200,80,tcp,http,65118,602,5,482,5,1084,10,malware,redlinestealer
1875747054239656020,10.127.0.81,8.8.8.8,53,udp,dns,876,4021,28,1981,28,6002,56,normal,-
1977597000765977775,10.127.0.81,80.66.64.60,80,tcp,http,5964,21809,378,863783,586,885592,964,malware,redlinestealer
4497426887800424367,10.127.0.81,104.26.12.31,443,tcp,http,4860,3853,7,710,8,4563,15,malware,redlinestealer
6123215297563415655,10.127.0.81,51.105.71.137,443,tcp,-,18953,0,0,322,7,322,7,malware,redlinestealer
-573483083516751509,10.127.0.81,209.197.3.8,80,tcp,-,32991,0,0,530,11,530,11,malware,redlinestealer
-5576330140223210275,10.127.0.108,193.56.146.220,4174,tcp,-,25636,121502,2709,9650960,7063,9772462,9772,malware,redlinestealer
-4977736486423936663,10.127.0.108,31.41.244.200,80,tcp,http,109998,407,5,523,6,930,11,malware,redlinestealer
-4587860651594509864,10.127.0.3,37.220.87.8,42823,tcp,-,4685,25321,452,1235692,940,1261013,1392,malware,redlinestealer
7553021666012571214,10.127.0.114,8.253.208.120,80,tcp,-,37923,0,0,644,14,644,14,malware,redlinestealer
313524823008963367,10.127.0.114,193.56.146.220,4174,tcp,-,10613,21022,372,1228116,920,1249138,1292,malware,redlinestealer
-1661741251152772489,10.127.0.114,31.41.244.200,80,tcp,http,110009,407,5,523,6,930,11,malware,redlinestealer
-3133825249642316153,10.127.0.114,20.189.173.2,443,tcp,-,19515,0,0,322,7,322,7,malware,redlinestealer
-6684214508929287957,10.127.0.114,131.253.33.203,80,tcp,-,18953,0,0,322,7,322,7,malware,redlinestealer
-9134363348265032464,10.127.0.182,193.56.146.220,4174,tcp,-,24115,65292,1318,4782825,3323,4848117,4641,malware,redlinestealer
-2805194496657936150,10.127.0.182,31.41.244.200,80,tcp,-,15031,0,0,260,5,260,5,malware,redlinestealer
-7643165680318741233,10.127.0.186,193.56.146.220,4174,tcp,-,13959,63218,1426,5056044,3699,5119262,5125,malware,redlinestealer
-7044572026519467621,10.127.0.186,31.41.244.200,80,tcp,http,110000,407,5,523,6,930,11,malware,redlinestealer
9207170875214196520,10.127.0.122,93.184.220.29,80,tcp,-,18946,0,0,322,7,322,7,malware,redlinestealer
1523679622155021376,10.127.0.122,193.233.20.28,4125,tcp,-,10764,46062,901,2696780,1987,2742842,2888,malware,redlinestealer
-4450988654851791894,10.127.0.122,193.56.146.220,4174,tcp,-,30589,65839,1150,4027345,2962,4093184,4112,malware,redlinestealer
-4697611893556974258,10.127.0.122,87.248.202.1,80,tcp,-,37905,0,0,644,14,644,14,malware,redlinestealer
4847912331444669939,10.127.0.188,193.56.146.220,4174,tcp,-,34721,42024,563,2354076,1732,2396100,2295,malware,redlinestealer
-8033849066226526499,10.127.0.188,31.41.244.200,80,tcp,http,329863,1221,15,1569,18,2790,33,malware,redlinestealer
2072386927826948441,10.127.0.188,52.182.141.63,443,tcp,-,72327,0,0,966,21,966,21,malware,redlinestealer
1281502211893703076,10.127.0.188,13.107.4.50,80,tcp,-,56862,0,0,966,21,966,21,malware,redlinestealer
6245942922416114187,10.127.0.68,195.20.17.139,80,tcp,http,23636,33004,645,1659060,1226,1692064,1871,malware,redlinestealer
-4468202925845890486,10.127.0.141,8.8.8.8,53,udp,dns,5146,970,11,707,11,1677,22,normal,-
-5861561088521012552,10.127.0.141,94.140.115.7,80,tcp,http,19844,70264,1561,5684414,3823,5754678,5384,malware,redlinestealer
-2246637685568777474,10.127.0.141,104.26.12.31,443,tcp,http,8075,4581,9,704,8,5285,17,malware,redlinestealer
-5566457336743399559,10.127.0.188,195.20.17.139,80,tcp,http,16492,40412,814,1512430,1131,1552842,1945,malware,redlinestealer
-3870652065938309324,10.127.0.188,104.26.13.31,443,tcp,http,10232,3851,7,756,9,4607,16,malware,redlinestealer
8487469734663683056,10.127.0.188,20.42.73.24,443,tcp,-,56858,0,0,966,21,966,21,malware,redlinestealer
8223564339446413582,10.127.0.107,193.56.146.218,80,tcp,http,108912,95170,76,2466,45,97636,121,malware,redlinestealer
7913955205111108984,10.127.0.99,193.233.20.28,4125,tcp,-,9894,10339,104,299652,247,309991,351,malware,redlinestealer
-5032930182841081882,10.127.0.99,193.56.146.220,4174,tcp,-,20580,29148,384,1466296,1111,1495444,1495,malware,redlinestealer
-74366727148579496,10.127.0.169,80.66.64.210,80,tcp,http,11292,25529,471,872768,641,898297,1112,malware,redlinestealer
6739384915351339838,10.127.0.169,104.26.13.31,443,tcp,http,4180,4541,8,704,8,5245,16,malware,redlinestealer
-6321163958898247673,10.127.0.176,80.66.64.210,80,tcp,http,13396,59886,1306,3679326,2678,3739212,3984,malware,redlinestealer
6816803647977755733,10.127.0.176,104.26.12.31,443,tcp,http,6158,4541,8,704,8,5245,16,malware,redlinestealer
5132273114718420294,10.127.0.167,193.56.146.220,4174,tcp,-,22529,24404,303,1208812,873,1233216,1176,malware,redlinestealer
6668872709911113612,10.127.0.167,31.41.244.200,80,tcp,http,175047,774,9,1000,11,1774,20,malware,redlinestealer
-8651440503479173399,10.127.0.2,193.233.20.28,4125,tcp,-,9517,8293,47,71812,74,80105,121,malware,redlinestealer
3820635293223564947,10.127.0.2,193.56.146.220,4174,tcp,-,32351,51616,913,3227270,2387,3278886,3300,malware,redlinestealer
3651048893285036997,10.127.0.123,193.56.146.220,4174,tcp,-,12125,51341,1110,3938855,2889,3990196,3999,malware,redlinestealer
1675782819123301141,10.127.0.123,31.41.244.200,80,tcp,http,109995,407,5,523,6,930,11,malware,redlinestealer
-4830259046604459236,10.127.0.191,193.56.146.220,4174,tcp,-,15058,37195,741,2837532,2088,2874727,2829,malware,redlinestealer
3752369837223090907,10.127.0.191,31.41.244.200,80,tcp,http,65125,602,5,482,5,1084,10,malware,redlinestealer
-1146462140359493437,10.127.0.22,193.233.20.28,4125,tcp,-,10908,55716,1204,3696668,2705,3752384,3909,malware,redlinestealer
-7121130417366306707,10.127.0.22,193.56.146.220,4174,tcp,-,11236,45453,975,3696467,2703,3741920,3678,malware,redlinestealer
6354413253509705803,10.127.0.182,193.56.146.218,80,tcp,http,49998,94895,74,3841,75,98736,149,malware,redlinestealer
-4063975556742333509,10.127.0.85,193.56.146.220,4174,tcp,-,11782,24838,388,1377860,1021,1402698,1409,malware,redlinestealer
-908016961582089272,10.127.0.85,193.56.146.218,80,tcp,http,109171,95170,76,2420,44,97590,120,malware,redlinestealer
3955519526895847942,10.127.0.180,193.56.146.220,4174,tcp,-,15018,40827,835,3061481,2223,3102308,3058,malware,redlinestealer
1906441275044632857,10.127.0.180,31.41.244.200,80,tcp,http,65124,602,5,482,5,1084,10,malware,redlinestealer
-8763648209840241102,10.127.0.207,8.8.8.8,53,udp,dns,7,73,1,57,1,130,2,normal,-
-5272159778282643685,10.127.0.207,144.76.136.153,443,tcp,tls,214,219,5,345,5,564,10,malware,redlinestealer
6204584900603620059,10.127.0.56,193.233.20.28,4125,tcp,-,10825,44782,966,2935169,2161,2979951,3127,malware,redlinestealer
-8196823840233223199,10.127.0.56,193.56.146.220,4174,tcp,-,10366,34058,697,2921185,2148,2955243,2845,malware,redlinestealer
-8827230915154965413,10.127.0.125,195.20.17.139,80,tcp,http,56461,4343,10,795,9,5138,19,malware,redlinestealer
539048235682696437,10.127.0.127,195.20.17.139,80,tcp,http,27284,69046,1525,5363914,3923,5432960,5448,malware,redlinestealer
5820531353531695075,10.127.0.127,104.26.13.31,443,tcp,tls,17981,3854,7,710,8,4564,15,malware,redlinestealer
-6190488307769078085,10.127.0.123,94.140.115.7,80,tcp,http,20105,54376,1115,3793739,2775,3848115,3890,malware,redlinestealer
7648653371803786648,10.127.0.123,104.26.13.31,443,tcp,http,8287,4541,8,704,8,5245,16,malware,redlinestealer
-5313539414048339862,10.127.0.104,193.56.146.220,4174,tcp,-,40963,17297,81,148758,158,166055,239,malware,redlinestealer
-8175297201840014672,10.127.0.104,31.41.244.200,80,tcp,http,130311,1204,10,964,10,2168,20,malware,redlinestealer
8020658475997530751,10.127.0.14,193.233.20.28,4125,tcp,-,10366,34479,673,1966412,1449,2000891,2122,malware,redlinestealer
2399186440475141612,10.127.0.118,93.184.221.240,80,tcp,-,181816,0,0,3096,66,3096,66,malware,redlinestealer
-6284965067270191395,10.127.0.118,144.76.136.153,443,tcp,http,1280,805260,585,14142,298,819402,883,malware,redlinestealer
5936328123850021555,10.127.0.118,89.23.97.112,34068,tcp,-,12909,49900,1044,3657005,2686,3706905,3730,malware,redlinestealer
-907363323938726817,10.127.0.118,20.42.65.85,443,tcp,-,37956,0,0,644,14,644,14,malware,redlinestealer
-3934183152535735498,10.127.0.118,204.79.197.203,80,tcp,-,37967,0,0,644,14,644,14,malware,redlinestealer
7147048820471983709,10.127.0.118,93.184.220.29,80,tcp,-,37906,0,0,644,14,644,14,malware,redlinestealer
-6074201154192622237,10.127.0.187,37.220.87.8,42823,tcp,-,6498,30017,543,1782503,1353,1812520,1896,malware,redlinestealer
-5756865151438298488,10.127.0.71,193.56.146.220,4174,tcp,-,33598,66616,1299,5165928,3714,5232544,5013,malware,redlinestealer
6242443287435669915,10.127.0.71,31.41.244.200,80,tcp,http,175065,1009,10,1005,11,2014,21,malware,redlinestealer
4530111651441235714,10.127.0.74,193.56.146.220,4174,tcp,-,11299,37939,794,2634523,1942,2672462,2736,malware,redlinestealer
-2760143810479756291,10.127.0.74,31.41.244.200,80,tcp,http,109986,407,5,523,6,930,11,malware,redlinestealer
-2657347341767061028,10.127.0.181,80.66.64.210,80,tcp,http,7995,48769,1052,2917767,2125,2966536,3177,malware,redlinestealer
5414809937866833651,10.127.0.181,104.26.13.31,443,tcp,http,6375,3853,7,756,9,4609,16,malware,redlinestealer
-9171256931496282889,10.127.0.97,193.56.146.220,4174,tcp,-,46410,70019,1165,4100553,3041,4170572,4206,malware,redlinestealer
254191779416676046,10.127.0.97,31.41.244.200,80,tcp,-,200095,1806,15,1842,23,3648,38,malware,redlinestealer
254535164754255317,10.127.0.96,82.115.223.46,57672,tcp,-,20040,43436,785,2745872,1996,2789308,2781,malware,redlinestealer
-7528846206652065376,10.127.0.100,193.56.146.220,4174,tcp,-,18321,16104,239,793599,599,809703,838,malware,redlinestealer
4470462232221903027,10.127.0.100,31.41.244.200,80,tcp,http,65152,602,5,482,5,1084,10,malware,redlinestealer
-2736271844540576740,10.127.0.121,193.56.146.220,4174,tcp,-,23074,15080,75,128649,141,143729,216,malware,redlinestealer
3245850345648044093,10.127.0.61,193.56.146.220,4174,tcp,-,11256,47350,1007,3563791,2413,3611141,3420,malware,redlinestealer
-1044334941110223830,10.127.0.61,193.56.146.218,80,tcp,http,115018,94935,75,3887,76,98822,151,malware,redlinestealer
-8297760951208810080,10.127.0.73,37.220.87.8,42823,tcp,-,6149,61481,1356,4380381,3314,4441862,4670,malware,redlinestealer
-5055656751585085256,10.127.0.78,193.56.146.220,4174,tcp,-,21364,13889,187,687241,522,701130,709,malware,redlinestealer
4369791959327873679,10.127.0.78,31.41.244.200,80,tcp,http,65155,602,5,482,5,1084,10,malware,redlinestealer
-2904002355168373788,10.127.0.71,82.115.223.46,57672,tcp,-,11114,18199,274,931443,698,949642,972,malware,redlinestealer
6558334271895423249,10.127.0.71,13.69.109.130,443,tcp,-,56853,0,0,966,21,966,21,malware,redlinestealer
5344805065636020632,10.127.0.10,8.8.8.8,53,udp,dns,10911,1002,10,959,15,1961,25,normal,-
4801765602519704663,10.127.0.10,87.236.16.109,80,tcp,http,219,689,5,412,5,1101,10,malware,formbook
-7522955439331428925,10.127.0.10,45.33.6.223,80,tcp,http,114865,572798,416,10516,221,583314,637,malware,formbook
-9063712563666843402,10.127.0.10,217.160.0.64,80,tcp,http,2252,1734,9,1273,10,3007,19,malware,formbook
-6829927231207878080,10.127.0.10,85.159.66.93,80,tcp,http,35063,504,6,6703,29,7207,35,malware,formbook
3706461705528195094,10.127.0.10,172.67.163.41,80,tcp,http,2167,1852,9,1225,10,3077,19,malware,formbook
7925233284702871850,10.127.0.10,81.17.29.149,80,tcp,http,128,572,5,417,5,989,10,malware,formbook
849334961020575984,10.127.0.10,199.192.28.121,80,tcp,http,3297,33543,29,1727,21,35270,50,malware,formbook
-348525799981060499,10.127.0.10,2.57.90.16,80,tcp,http,2204,962,9,1241,10,2203,19,malware,formbook
890782673122132182,10.127.0.180,20.189.173.5,443,tcp,-,41249,0,0,644,14,644,14,malware,formbook
783302297778861572,10.127.0.180,8.238.177.126,80,tcp,-,90845,0,0,1548,33,1548,33,malware,formbook
-3027839769605420187,10.127.0.180,173.223.113.164,443,tcp,-,56871,0,0,966,21,966,21,malware,formbook
304803937387174479,10.127.0.180,173.223.113.131,80,tcp,-,56859,0,0,966,21,966,21,malware,formbook
3929997305902974214,10.127.0.180,131.253.33.203,80,tcp,-,37905,0,0,644,14,644,14,malware,formbook
4979898541199760024,10.127.0.24,68.178.226.166,80,tcp,http,762,691,5,416,5,1107,10,malware,formbook
8037959963160128946,10.127.0.24,45.33.6.223,80,tcp,http,229832,972531,704,18094,378,990625,1082,malware,formbook
8251173550263251048,10.127.0.24,43.156.255.190,80,tcp,http,3588,1756,9,1232,10,2988,19,malware,formbook
1687448984873717388,10.127.0.24,147.255.250.112,80,tcp,http,2761,766,9,1224,10,1990,19,malware,formbook
771738428370849896,10.127.0.24,47.90.30.95,80,tcp,http,3173,4264,11,1320,12,5584,23,malware,formbook
2450260925360227630,10.127.0.24,51.79.231.12,80,tcp,http,3151,3564,11,1328,12,4892,23,malware,formbook
-6503459588939698485,10.127.0.24,195.110.124.133,80,tcp,http,2265,1110,9,1252,10,2362,19,malware,formbook
-264418055625427899,10.127.0.24,210.211.120.158,80,tcp,http,3183,1346,9,1256,10,2602,19,malware,formbook
4685968415410836920,10.127.0.24,154.36.192.148,80,tcp,http,3317,1064,12,1328,12,2392,24,malware,formbook
6392823729514423763,10.127.0.24,63.250.35.33,80,tcp,http,2922,1465,9,1228,10,2693,19,malware,formbook
3470088540544055029,10.127.0.24,91.216.107.206,80,tcp,http,2431,1144,9,1260,10,2404,19,malware,formbook
-7029594301497737778,10.127.0.24,185.154.137.201,80,tcp,http,2217,1555,9,1268,10,2823,19,malware,formbook
7060488689623240492,10.127.0.24,94.152.2.95,80,tcp,http,82,532,4,783,4,1315,8,malware,formbook
-4647326745719596925,10.127.0.80,87.236.16.109,80,tcp,http,177,689,5,422,5,1111,10,malware,formbook
8300244015092486001,10.127.0.80,217.160.0.64,80,tcp,http,4657,3278,18,4437,21,7715,39,malware,formbook
3488000058916594498,10.127.0.80,85.159.66.93,80,tcp,http,52853,1368,15,26806,63,28174,78,malware,formbook
5065280885910726421,10.127.0.80,104.21.81.174,80,tcp,http,4563,3626,18,4317,21,7943,39,malware,formbook
-5873723086149079277,10.127.0.80,81.17.29.149,80,tcp,http,4658,2897,18,4357,21,7254,39,malware,formbook
1468739583032514613,10.127.0.80,199.192.28.121,80,tcp,http,5896,68283,58,5279,42,73562,100,malware,formbook
-4127478560953489998,10.127.0.80,2.57.90.16,80,tcp,http,4603,1924,18,4357,21,6281,39,malware,formbook
-542185593292999092,10.127.0.51,52.109.77.2,443,tcp,-,0,40,1,0,0,40,1,malware,formbook
5217113360640588244,10.127.0.51,199.59.243.222,80,tcp,http,174,2279,6,470,6,2749,12,malware,formbook
603213145239771910,10.127.0.51,72.14.178.174,80,tcp,http,5227,62260,54,5374,42,67634,96,malware,formbook
-8021370889592972570,10.127.0.51,5.181.216.141,80,tcp,http,5808,7528,21,4610,26,12138,47,malware,formbook
5918290102149556750,10.127.0.51,213.171.195.105,80,tcp,http,4594,8536,21,4390,23,12926,44,malware,formbook
-3506926368296823062,10.127.0.51,185.151.30.181,80,tcp,http,4625,1895,17,4388,21,6283,38,malware,formbook
-6402044039767898231,10.127.0.51,194.85.61.76,80,tcp,http,4864,40391,46,5054,37,45445,83,malware,formbook
5548521256732350949,10.127.0.51,192.64.116.162,80,tcp,http,5738,67191,58,5218,41,72409,99,malware,formbook
1996755923793364582,10.127.0.51,162.209.159.142,80,tcp,http,1801,3028,19,806,17,3834,36,malware,formbook
2492645178323358645,10.127.0.24,216.40.34.41,80,tcp,http,353,6918,9,567,8,7485,17,malware,formbook
235705475606282322,10.127.0.24,160.124.116.169,80,tcp,http,3002,651,8,1261,10,1912,18,malware,formbook
-1152281482186970019,10.127.0.24,172.67.153.85,80,tcp,http,2343,1682,11,1329,12,3011,23,malware,formbook
-5406697496217118841,10.127.0.24,162.0.231.77,80,tcp,http,2903,7293,12,1337,12,8630,24,malware,formbook
7314916855203671670,10.127.0.24,104.143.9.110,80,tcp,http,2482,2509,9,1245,10,3754,19,malware,formbook
-4432754897441785828,10.127.0.24,31.31.196.245,80,tcp,http,2627,376323,275,7413,144,383736,419,malware,formbook
-377069069648102903,10.127.0.24,91.189.114.29,80,tcp,http,2411,81950,65,2545,38,84495,103,malware,formbook
8275377335398889963,10.127.0.24,130.185.109.77,80,tcp,http,2194,1023,9,1273,10,2296,19,malware,formbook
-2006624675149978720,10.127.0.24,81.17.29.149,80,tcp,http,2229,1783,9,1245,10,3028,19,malware,formbook
-1417539144842061871,10.127.0.24,212.123.41.108,80,tcp,http,2187,2061,8,1261,10,3322,18,malware,formbook
4784737229891059503,10.127.0.24,104.21.67.180,80,tcp,http,2345,4102,12,1357,12,5459,24,malware,formbook
-7823632727686901894,10.127.0.24,45.194.145.38,80,tcp,http,3198,1025,7,1253,10,2278,17,malware,formbook
8252995577163287182,10.127.0.24,62.149.128.45,80,tcp,http,2138,5383,5,869,6,6252,11,malware,formbook
5670351097343984598,10.127.0.120,92.222.139.190,80,tcp,http,79,615,4,425,5,1040,9,malware,formbook
7275767186536476611,10.127.0.120,192.187.111.219,80,tcp,http,5273,2935,19,6469,24,9404,43,malware,formbook
8309307217670509530,10.127.0.120,172.105.90.131,80,tcp,-,86149,1360,4,1481,25,2841,29,malware,formbook
7597838555923916542,10.127.0.120,8.241.154.254,80,tcp,-,2,120,3,138,3,258,6,malware,formbook
1692500386512835040,10.127.0.120,154.64.36.77,80,tcp,http,5729,2282,21,6509,26,8791,47,malware,formbook
-4777164452277220352,10.127.0.193,192.229.221.95,80,tcp,-,1,40,1,46,1,86,2,malware,formbook
6247685946260032211,10.127.0.193,199.59.243.222,80,tcp,http,260,2391,8,528,7,2919,15,malware,formbook
-2279314063123404142,10.127.0.193,45.33.18.44,80,tcp,http,55488,50033,43,6792,45,56825,88,malware,formbook
-18581193028151007,10.127.0.193,5.181.216.141,80,tcp,http,23853,7665,22,6890,31,14555,53,malware,formbook
-2384200532077890547,10.127.0.193,45.56.79.23,80,tcp,http,441,362,4,494,6,856,10,malware,formbook
-2228321095025112119,10.127.0.193,213.171.195.105,80,tcp,http,4768,8664,23,6484,25,15148,48,malware,formbook
-8813334113757116269,10.127.0.141,52.60.87.163,80,tcp,http,246,18240,16,947,17,19187,33,malware,formbook
-3756493214999747377,10.127.0.141,109.70.26.37,80,tcp,http,94,1966,4,441,6,2407,10,malware,formbook
-3767088731990231210,10.127.0.141,160.121.108.17,80,tcp,http,841,881,4,393,5,1274,9,malware,formbook
2781978938389563333,10.127.0.141,185.53.179.94,80,tcp,http,58,533,6,401,5,934,11,malware,formbook
-2302715592527488539,10.127.0.171,20.50.80.209,443,tcp,-,18952,0,0,322,7,322,7,malware,formbook
2957674687188276959,10.127.0.171,216.40.34.41,80,tcp,http,302,6918,9,564,8,7482,17,malware,formbook
700734984471200636,10.127.0.171,160.124.116.169,80,tcp,http,5859,1649,17,4374,21,6023,38,malware,formbook
8056288360447024881,10.127.0.171,84.53.175.11,80,tcp,-,18968,0,0,322,7,322,7,malware,formbook
-687251973322051705,10.127.0.171,172.67.153.85,80,tcp,http,3489,3414,23,4406,23,7820,46,malware,formbook
-4941667987352200527,10.127.0.171,162.0.231.77,80,tcp,http,5613,14491,22,4518,25,19009,47,malware,formbook
-7106574730905571088,10.127.0.171,173.223.113.131,80,tcp,-,18953,0,0,322,7,322,7,malware,formbook
8466169244426542521,10.127.0.171,204.79.197.203,80,tcp,-,18952,0,0,322,7,322,7,malware,formbook
-4648693451613435868,10.127.0.171,8.247.210.254,80,tcp,-,18968,0,0,322,7,322,7,malware,formbook
2578179218227952832,10.127.0.171,104.143.9.111,80,tcp,http,4999,4723,18,4334,21,9057,39,malware,formbook
-3967725388576867514,10.127.0.171,31.31.196.245,80,tcp,http,5032,510897,376,12578,200,523475,576,malware,formbook
4486317822201183539,10.127.0.171,91.189.114.29,80,tcp,http,4886,163900,130,6940,77,170840,207,malware,formbook
3148900908513603844,10.127.0.171,130.185.109.77,80,tcp,http,4579,2011,17,4404,21,6415,38,malware,formbook
2856762216699307722,10.127.0.171,81.17.29.149,80,tcp,http,4663,2884,18,4334,21,7218,39,malware,formbook
7031525594051132974,10.127.0.171,212.123.41.108,80,tcp,http,4586,3745,16,4374,21,8119,37,malware,formbook
6784304110474486155,10.127.0.113,20.123.141.233,443,tcp,-,0,40,1,0,0,40,1,malware,formbook
-6308842479646467668,10.127.0.212,8.8.8.8,53,udp,dns,438,437,5,315,5,752,10,normal,-
2082752390691360046,10.127.0.212,136.143.186.12,80,tcp,http,462,5489,7,522,7,6011,14,malware,formbook
-729858910904365609,10.127.0.212,45.33.6.223,80,tcp,http,1710,460020,337,10300,198,470320,535,malware,formbook
1244554178884353438,10.127.0.212,156.226.16.186,80,tcp,http,2897,962,9,1285,11,2247,20,malware,formbook
-6659564545492053432,10.127.0.212,93.89.226.17,80,tcp,http,27528,1059,3,2817,16,3876,19,malware,formbook
6524831738913261576,10.127.0.212,156.236.68.182,80,tcp,http,3058,962,9,1235,10,2197,19,malware,formbook
7973591915271691768,10.127.0.84,8.8.8.8,53,udp,dns,2757,3205,37,2426,38,5631,75,normal,-
-5733520483202733183,10.127.0.84,68.178.226.166,80,tcp,http,798,691,5,414,5,1105,10,malware,formbook
9154218101029425699,10.127.0.84,45.33.6.223,80,tcp,-,102791,525752,381,15096,281,540848,662,malware,formbook
3697292100865675712,10.127.0.84,43.156.255.190,80,tcp,http,3643,1756,9,1225,10,2981,19,malware,formbook
5022416651196407669,10.127.0.84,147.255.250.112,80,tcp,http,12992,25188,24,1746,21,26934,45,malware,formbook
-4271541008764771222,10.127.0.84,47.90.30.95,80,tcp,http,3244,4264,11,1313,12,5577,23,malware,formbook
-8263158099042265577,10.127.0.84,51.79.231.12,80,tcp,http,3186,3564,11,1321,12,4885,23,malware,formbook
1658827837564455093,10.127.0.84,195.110.124.133,80,tcp,http,2306,1110,9,1245,10,2355,19,malware,formbook
8740689197964134471,10.127.0.84,210.211.120.158,80,tcp,http,3285,1346,9,1249,10,2595,19,malware,formbook
132086966013261584,10.127.0.84,154.36.192.148,80,tcp,http,343,607,5,815,5,1422,10,malware,formbook
8259588566975989034,10.127.0.199,23.90.21.164,80,tcp,http,2387,522,5,392,5,914,10,malware,formbook
9193501260764807441,10.127.0.199,23.227.38.74,80,tcp,http,30,6518,10,581,9,7099,19,malware,formbook
-3320885755821806846,10.127.0.199,151.106.97.99,80,tcp,http,322,1284,5,398,5,1682,10,malware,formbook
-8870093472159577548,10.127.0.199,160.124.149.73,80,tcp,http,647,2889,5,451,6,3340,11,malware,formbook
6887297437262570924,10.127.0.71,103.153.3.23,80,tcp,http,808,1280,5,421,5,1701,10,malware,formbook
7584585722883374887,10.127.0.71,154.213.25.52,80,tcp,http,6118,2000,19,7054,24,9054,43,malware,formbook
1672580693854524218,10.127.0.71,162.213.249.254,80,tcp,http,25548,2932,18,6645,28,9577,46,malware,formbook
6748229732961177364,10.127.0.71,192.124.249.5,80,tcp,http,5056,232024,184,10468,108,242492,292,malware,formbook
2847021532817617242,10.127.0.71,148.66.54.130,80,tcp,http,5862,2760,19,6389,23,9149,42,malware,formbook
-362615413695401611,10.127.0.71,156.236.67.182,80,tcp,http,6120,2000,19,6363,23,8363,42,malware,formbook
2772744291582083427,10.127.0.71,54.36.91.62,80,tcp,http,5042,174152,162,9779,95,183931,257,malware,formbook
-1667027169128797163,10.127.0.71,185.199.108.153,80,tcp,http,4587,2087,14,6076,18,8163,32,malware,formbook
6787203011826626921,10.127.0.125,136.143.186.12,80,tcp,http,501,5489,7,521,7,6010,14,malware,formbook
-5022747607857979309,10.127.0.125,156.226.16.186,80,tcp,http,5862,2012,19,6547,26,8559,45,malware,formbook
-1955113924356786557,10.127.0.125,93.89.226.17,80,tcp,http,24037,3113,8,5679,26,8792,34,malware,formbook
6830924977064160323,10.127.0.125,156.236.68.182,80,tcp,http,6096,2000,19,6396,23,8396,42,malware,formbook
9177468094120898271,10.127.0.125,66.235.200.251,80,tcp,http,3344,3141,18,6142,19,9283,37,malware,formbook
4896828713961292994,10.127.0.172,81.169.145.88,80,tcp,http,115,586,5,431,5,1017,10,malware,formbook
-1167141812245176983,10.127.0.172,45.33.6.223,80,tcp,http,113790,447278,324,8308,173,455586,497,malware,formbook
-2510340498652780653,10.127.0.172,50.87.195.203,80,tcp,http,13059,3033,10,1340,11,4373,21,malware,formbook
7901481795937622002,10.127.0.172,199.192.28.110,80,tcp,http,2883,1465,9,1236,10,2701,19,malware,formbook
-6052427256184074629,10.127.0.172,217.160.0.32,80,tcp,http,2228,2046,9,1280,10,3326,19,malware,formbook
1690042586505178798,10.127.0.172,113.52.135.193,80,tcp,http,3124,1170,9,1244,10,2414,19,malware,formbook
-2715553730812834882,10.127.0.172,20.0.240.191,80,tcp,-,37964,0,0,408,8,408,8,malware,formbook
6812337938018278901,10.127.0.172,37.97.254.29,80,tcp,http,37,280,2,775,4,1055,6,malware,formbook
4102846394264930242,10.127.0.191,87.236.16.109,80,tcp,http,268,689,5,424,5,1113,10,malware,formbook
-5364274388937249695,10.127.0.191,217.160.0.64,80,tcp,http,34848,3343,18,6802,28,10145,46,malware,formbook
3029048518526633498,10.127.0.191,85.159.66.93,80,tcp,http,24086,1276,13,7855,28,9131,41,malware,formbook
-281426025201648489,10.127.0.191,104.21.81.174,80,tcp,http,3308,3706,19,6331,22,10037,41,malware,formbook
-4510428398754919778,10.127.0.191,81.17.29.146,80,tcp,http,16615,532,4,1082,10,1614,14,malware,formbook
-4172210052233187893,10.127.0.169,209.197.3.8,80,tcp,-,101889,0,0,1746,36,1746,36,malware,formbook
2410541351231784014,10.127.0.169,93.184.220.29,80,tcp,-,18949,0,0,322,7,322,7,malware,formbook
-214526484969360770,10.127.0.169,20.50.201.195,443,tcp,-,19043,0,0,322,7,322,7,malware,formbook
2804450428966178883,10.127.0.169,173.223.113.164,443,tcp,-,18953,0,0,322,7,322,7,malware,formbook
2581556580059814213,10.127.0.169,173.223.113.131,80,tcp,-,18953,0,0,322,7,322,7,malware,formbook
-7412674364952474371,10.127.0.169,131.253.33.203,80,tcp,-,18953,0,0,322,7,322,7,malware,formbook
2491771168275821953,10.127.0.166,93.184.221.240,80,tcp,-,135900,0,0,2328,48,2328,48,malware,formbook
-967994659546599629,10.127.0.166,13.69.239.74,443,tcp,-,18952,0,0,322,7,322,7,malware,formbook
-2395010364552754156,10.127.0.166,8.248.3.254,80,tcp,-,18952,0,0,322,7,322,7,malware,formbook
2318553238247802770,10.127.0.166,173.223.113.164,443,tcp,-,37903,0,0,644,14,644,14,malware,formbook
-3097024460356620231,10.127.0.166,173.223.113.131,80,tcp,-,18952,0,0,322,7,322,7,malware,formbook
-2110558523859454481,10.127.0.166,204.79.197.203,80,tcp,-,18952,0,0,322,7,322,7,malware,formbook
-6810756475663208687,10.127.0.67,104.21.87.153,80,tcp,http,21,963,5,387,5,1350,10,malware,formbook
-4790909104820995913,10.127.0.67,34.102.136.180,80,tcp,http,116,689,5,396,5,1085,10,malware,formbook
1745122860057369691,10.127.0.67,54.161.222.85,80,tcp,http,265,342,4,388,5,730,9,malware,formbook
5253917320902684017,10.127.0.67,84.21.172.28,80,tcp,-,7034,0,0,208,4,208,4,malware,formbook
7199589959265036131,10.127.0.60,20.123.141.233,443,tcp,-,0,40,1,0,0,40,1,malware,formbook
4259375117319509631,10.127.0.60,172.67.220.57,80,tcp,http,19,979,5,399,5,1378,10,malware,formbook
-3989715511179111442,10.127.0.60,91.207.183.44,80,tcp,-,22031,0,0,468,9,468,9,malware,formbook
-8505886324400695707,10.127.0.60,23.227.38.74,80,tcp,http,50,6480,9,532,8,7012,17,malware,formbook
2432156878759779828,10.127.0.162,40.126.32.133,443,tcp,-,15031,0,0,260,5,260,5,malware,formbook
-850008510814173413,10.127.0.134,74.208.236.171,80,tcp,http,355,1691,6,448,6,2139,12,malware,formbook
-4102646582746588725,10.127.0.134,34.117.168.233,80,tcp,http,70,4116,7,441,6,4557,13,malware,formbook
-272285179385145425,10.127.0.123,194.1.147.59,80,tcp,http,214,1387,5,352,4,1739,9,malware,formbook
7551016259140190285,10.127.0.123,142.250.179.211,80,tcp,http,189,1112,5,447,6,1559,11,malware,formbook
-8140199389424606847,10.127.0.192,209.197.3.8,80,tcp,-,37885,0,0,644,14,644,14,malware,formbook
7393999117839952243,10.127.0.192,8.253.208.120,80,tcp,-,33971,0,0,582,12,582,12,malware,formbook
-6755595942942037815,10.127.0.192,52.152.110.14,443,tcp,-,15046,0,0,260,5,260,5,malware,formbook
7277749814574341686,10.127.0.192,46.30.211.38,80,tcp,-,85095,513,4,674,10,1187,14,malware,formbook
2628568130911657334,10.127.0.192,20.42.73.26,443,tcp,-,18953,0,0,322,7,322,7,malware,formbook
1697232848133043499,10.127.0.192,2.57.90.16,80,tcp,http,128,501,5,363,4,864,9,malware,formbook
-3700154986376777773,10.127.0.192,190.115.24.78,80,tcp,http,99,563,5,396,5,959,10,malware,formbook
3830708982042748483,10.127.0.192,192.185.60.72,80,tcp,http,594,678,4,404,5,1082,9,malware,formbook
-149341719041064155,10.127.0.192,34.102.136.180,80,tcp,http,204,689,5,405,5,1094,10,malware,formbook
-5968288670767189842,10.127.0.175,52.109.8.44,443,tcp,-,0,40,1,0,0,40,1,malware,formbook
-8514834603277420139,10.127.0.107,179.43.175.187,80,tcp,http,8342,5578016,3993,165358,2749,5743374,6742,malware,formbook
-8258207613686504729,10.127.0.107,169.62.176.227,80,tcp,http,1508,5331,100,164027,127,169358,227,malware,formbook
2000166045527625887,10.127.0.110,81.169.145.88,80,tcp,http,117,586,5,431,5,1017,10,malware,formbook
8464989652324421815,10.127.0.110,20.82.154.241,443,tcp,-,15020,0,0,260,5,260,5,malware,formbook
2971243936371863639,10.127.0.110,50.87.195.203,80,tcp,http,15777,5707,18,4510,22,10217,40,malware,formbook
1987172919714759930,10.127.0.110,199.192.28.110,80,tcp,http,5674,2991,19,6389,23,9380,42,malware,formbook
-8949089924617741736,10.127.0.110,217.160.0.32,80,tcp,http,4776,3868,19,6532,23,10400,42,malware,formbook
2821762998917173551,10.127.0.110,113.52.135.193,80,tcp,http,6767,2416,19,7319,25,9735,44,malware,formbook
6305015797319425488,10.127.0.110,20.0.240.191,80,tcp,-,51130,0,0,728,14,728,14,malware,formbook
5308082556684082768,10.127.0.129,179.43.175.187,80,tcp,http,8497,5401532,3871,105785,2097,5507317,5968,malware,formbook
-80458068712180848,10.127.0.129,104.16.16.194,80,tcp,http,692,7992,103,150254,122,158246,225,malware,formbook
7875019372345668868,10.127.0.129,38.59.53.186,80,tcp,http,1783,2580,63,149924,117,152504,180,malware,formbook
8934457911139332686,10.127.0.104,52.109.8.44,443,tcp,-,0,40,1,0,0,40,1,malware,formbook
-4103818898175053971,10.127.0.101,52.242.97.97,443,tcp,-,15027,0,0,260,5,260,5,malware,formbook
8002271474563299184,10.127.0.174,209.197.3.8,80,tcp,-,78227,0,0,1288,28,1288,28,malware,formbook
1534237710950042331,10.127.0.174,20.50.73.9,443,tcp,-,38582,0,0,644,14,644,14,malware,formbook
4915256459338614170,10.127.0.174,173.223.113.164,443,tcp,-,40900,0,0,644,14,644,14,malware,formbook
4746527789245007033,10.127.0.174,13.107.4.50,80,tcp,-,41262,0,0,644,14,644,14,malware,formbook
3360144795608794926,10.127.0.174,173.223.113.131,80,tcp,-,42244,0,0,644,14,644,14,malware,formbook
486144697231356919,10.127.0.174,204.79.197.203,80,tcp,-,42244,0,0,644,14,644,14,malware,formbook
-2245942191433502105,10.127.0.124,199.59.243.222,80,tcp,http,174,2271,6,468,6,2739,12,malware,formbook
-3548748909267217482,10.127.0.124,45.33.6.223,80,tcp,http,115115,504531,365,9378,196,513909,561,malware,formbook
-5757032243331539088,10.127.0.124,96.126.123.244,80,tcp,http,2535,25452,24,1683,19,27135,43,malware,formbook
7360675015026856825,10.127.0.124,5.181.216.141,80,tcp,http,2962,3784,11,1345,12,5129,23,malware,formbook
-7136271385674738032,10.127.0.124,213.171.195.105,80,tcp,http,2113,7574,13,1317,12,8891,25,malware,formbook
-9145484265347554751,10.127.0.124,185.151.30.181,80,tcp,http,2112,1083,9,1261,10,2344,19,malware,formbook
839794667147604060,10.127.0.124,109.70.26.37,80,tcp,http,2279,20152,22,1601,18,21753,40,malware,formbook
-1914534295341739400,10.127.0.124,192.64.116.162,80,tcp,http,2951,33603,29,1685,20,35288,49,malware,formbook
741731307095910693,10.127.0.124,162.209.159.142,80,tcp,http,925,1534,10,380,8,1914,18,malware,formbook
35508703605156050,10.127.0.124,62.4.21.190,80,tcp,http,2078,1222,9,1273,10,2495,19,malware,formbook
-4408514897232117786,10.127.0.124,88.99.217.197,80,tcp,http,2107,1342,9,1249,10,2591,19,malware,formbook
-9180670059188595872,10.127.0.124,68.178.226.166,80,tcp,http,759,691,5,431,5,1122,10,malware,formbook
-9005674909430967469,10.127.0.124,43.156.255.190,80,tcp,http,6779,3588,19,6402,23,9990,42,malware,formbook
6721515494638106564,10.127.0.124,152.195.38.76,80,tcp,-,0,40,1,46,1,86,2,malware,formbook
-2853230598918772215,10.127.0.124,147.255.250.112,80,tcp,http,41037,25666,30,6812,44,32478,74,malware,formbook
-672661296115777086,10.127.0.124,47.90.30.95,80,tcp,http,20916,8593,22,6842,32,15435,54,malware,formbook
-9136447947067118798,10.127.0.124,51.79.231.12,80,tcp,http,4588,5478,18,6415,23,11893,41,malware,formbook
4299540489433894980,10.127.0.107,50.116.93.86,80,tcp,http,971,534,5,448,6,982,11,malware,formbook
-2050949271379559002,10.127.0.107,192.161.187.200,80,tcp,http,498,642,5,397,5,1039,10,malware,formbook
-7153470446157166683,10.127.0.107,34.102.136.180,80,tcp,http,168,689,5,407,5,1096,10,malware,formbook
113868047294563035,10.127.0.122,1.13.186.125,80,tcp,http,853,314,4,426,5,740,9,malware,formbook
4000815763042912244,10.127.0.122,45.33.6.223,80,tcp,http,115084,457113,331,8446,176,465559,507,malware,formbook
3639091503857015205,10.127.0.122,198.46.160.97,80,tcp,http,2398,1069,10,1262,11,2331,21,malware,formbook
-218005313014619022,10.127.0.122,219.94.129.181,80,tcp,http,3488,76424,62,2416,36,78840,98,malware,formbook
5266254334764341728,10.127.0.122,104.21.33.160,80,tcp,http,2390,17535,23,1592,18,19127,41,malware,formbook
-7667837401682695472,10.127.0.122,162.0.231.77,80,tcp,http,2757,7293,12,1324,12,8617,24,malware,formbook
8125772969783101491,10.127.0.122,162.241.24.110,80,tcp,http,2625,1342,9,1260,10,2602,19,malware,formbook
-7566291144718209582,10.127.0.122,67.222.24.48,80,tcp,http,2485,22966,23,1570,17,24536,40,malware,formbook
-1509648221688080445,10.127.0.122,49.212.180.95,80,tcp,http,3116,1102,9,1244,10,2346,19,malware,formbook
-4662097365646759465,10.127.0.122,34.120.137.41,80,tcp,http,2229,113094,92,3180,52,116274,144,malware,formbook
-5999705315943385955,10.127.0.122,208.91.197.91,80,tcp,http,424,3772,8,1226,9,4998,17,malware,formbook
8361971440557073091,10.127.0.122,45.194.145.38,80,tcp,http,3025,985,6,1244,10,2229,16,malware,formbook
-6757904642088423619,10.127.0.127,68.178.226.166,80,tcp,-,20555,632,4,697,10,1329,14,malware,formbook
7071265324964353404,10.127.0.127,43.156.255.190,80,tcp,-,20766,886,4,696,10,1582,14,malware,formbook
-5223034438233002958,10.127.0.127,147.255.250.112,80,tcp,-,15596,24826,20,1430,26,26256,46,malware,formbook
5261969790338824341,10.127.0.127,47.90.30.95,80,tcp,-,15590,2117,5,741,11,2858,16,malware,formbook
5130818734935933743,10.127.0.127,51.79.231.12,80,tcp,http,784,1802,6,474,6,2276,12,malware,formbook
634443678678764657,10.127.0.127,195.110.124.133,80,tcp,http,1549,651,6,4354,8,5005,14,malware,formbook
7419417727116568067,10.127.0.98,20.190.146.37,443,tcp,-,15035,0,0,260,5,260,5,malware,formbook
-7705487059237070066,10.127.0.98,52.109.77.0,443,tcp,-,0,40,1,0,0,40,1,malware,formbook
-2284705382359981384,10.127.0.98,152.195.38.76,80,tcp,-,1,40,1,46,1,86,2,malware,formbook
8555725059634726238,10.127.0.184,40.125.122.176,443,tcp,-,30102,0,0,520,10,520,10,malware,formbook
-5173772544484548474,10.127.0.121,1.13.186.125,80,tcp,http,890,314,4,426,5,740,9,malware,formbook
3973097138973057196,10.127.0.121,198.46.160.97,80,tcp,http,5223,2149,19,6394,24,8543,43,malware,formbook
8542740785931452957,10.127.0.121,219.94.129.181,80,tcp,http,6658,282531,218,11756,140,294287,358,malware,formbook
-2796234272232313071,10.127.0.121,172.67.164.201,80,tcp,http,3901,29627,45,7048,37,36675,82,malware,formbook
-7285338406194934892,10.127.0.121,162.0.231.77,80,tcp,http,5649,14567,23,6584,27,21151,50,malware,formbook
1951640664374051028,10.127.0.121,162.241.24.110,80,tcp,http,5532,2644,17,4402,21,7046,38,malware,formbook
-5851574334406994428,10.127.0.121,67.222.24.48,80,tcp,http,4247,59538,57,7234,40,66772,97,malware,formbook
5032388348804598006,10.127.0.121,49.212.180.95,80,tcp,http,6245,2320,20,6439,23,8759,43,malware,formbook
8925968493480775811,10.127.0.121,34.120.137.41,80,tcp,http,4867,168102,139,9258,84,177360,223,malware,formbook
-6997917495650798538,10.127.0.121,208.91.197.91,80,tcp,-,-1,0,0,0,0,0,0,malware,formbook
-5681606459133198410,10.127.0.126,20.190.159.75,443,tcp,-,45087,0,0,780,15,780,15,malware,formbook
-4335886798961032895,10.127.0.126,51.81.106.95,80,tcp,http,399,680,5,393,5,1073,10,malware,formbook
-5799926555271150695,10.127.0.126,23.227.38.74,80,tcp,http,60,6476,9,540,8,7016,17,malware,formbook
-1952053995209257908,10.127.0.126,51.255.117.202,80,tcp,http,79,616,4,395,5,1011,9,malware,formbook
-7383751636561505907,10.127.0.126,160.121.108.17,80,tcp,http,816,881,4,395,5,1276,9,malware,formbook
8355139473739927325,10.127.0.31,1.13.186.125,80,tcp,http,890,314,4,430,5,744,9,malware,formbook
7843729806503908406,10.127.0.31,45.33.6.223,80,tcp,http,115047,459549,333,8722,182,468271,515,malware,formbook
-8390878798430530781,10.127.0.31,198.46.160.97,80,tcp,http,2550,1029,9,1226,10,2255,19,malware,formbook
6198768458407386608,10.127.0.31,219.94.129.181,80,tcp,http,3394,76428,62,2426,36,78854,98,malware,formbook
5062538158725290639,10.127.0.31,172.67.164.201,80,tcp,http,2496,17557,23,1602,18,19159,41,malware,formbook
129647544934483321,10.127.0.31,162.0.231.77,80,tcp,http,2884,7293,12,1334,12,8627,24,malware,formbook
4079837897523832036,10.127.0.31,162.241.24.110,80,tcp,http,2757,1342,9,1270,10,2612,19,malware,formbook
-3723377101257213420,10.127.0.31,67.222.24.48,80,tcp,http,2643,22970,23,1580,17,24550,40,malware,formbook
8003405409039787806,10.127.0.31,49.212.180.95,80,tcp,http,3248,1102,9,1254,10,2356,19,malware,formbook
990490230206505029,10.127.0.31,34.120.137.41,80,tcp,http,2403,113174,94,3236,53,116410,147,malware,formbook
-2156791272482389793,10.127.0.31,208.91.197.91,80,tcp,http,514,4665,9,1288,10,5953,19,malware,formbook
730358521253895233,10.127.0.31,45.194.145.38,80,tcp,http,3377,1025,7,1254,10,2279,17,malware,formbook
-5005750463095199061,10.127.0.119,199.59.243.222,80,tcp,http,169,2279,6,471,6,2750,12,malware,formbook
7739829509796269050,10.127.0.119,45.33.6.223,80,tcp,http,969,504571,366,9136,191,513707,557,malware,formbook
-6358566597080793129,10.127.0.119,96.126.123.244,80,tcp,http,2588,25446,24,1686,19,27132,43,malware,formbook
-3383168486663116662,10.127.0.119,5.181.216.141,80,tcp,http,2817,3784,11,1348,12,5132,23,malware,formbook
-3461753894500821763,10.127.0.119,213.171.195.105,80,tcp,http,2172,7574,13,1320,12,8894,25,malware,formbook
-1442583693327976622,10.127.0.119,185.151.30.181,80,tcp,http,2193,1083,9,1264,10,2347,19,malware,formbook
8824193612296192743,10.127.0.119,194.85.61.76,80,tcp,http,2361,20199,23,2231,19,22430,42,malware,formbook
-4674342567003436356,10.127.0.119,192.64.116.162,80,tcp,http,3034,33603,29,1688,20,35291,49,malware,formbook
2774492291848616733,10.127.0.119,162.209.159.142,80,tcp,http,921,1534,10,380,8,1914,18,malware,formbook
5164549547663724711,10.127.0.119,62.4.21.190,80,tcp,http,2158,1222,9,1276,10,2498,19,malware,formbook
7692743057771828471,10.127.0.119,88.99.217.197,80,tcp,http,2125,651,4,829,5,1480,9,malware,formbook
6529030696685866269,10.127.0.216,92.255.108.52,80,tcp,http,346,19732,17,988,18,20720,35,malware,formbook
-7274317142770020327,10.127.0.216,160.121.108.17,80,tcp,http,770,881,4,388,5,1269,9,malware,formbook
5854641342931118435,10.127.0.104,1.13.186.125,80,tcp,http,3895,314,4,544,7,858,11,malware,formbook
4981507416509202477,10.127.0.104,198.46.160.97,80,tcp,http,5227,2149,19,6412,24,8561,43,malware,formbook
-2461267247406340153,10.127.0.104,219.94.129.181,80,tcp,http,6988,205584,163,10792,117,216376,280,malware,formbook
6608670247416529000,10.127.0.104,104.21.33.160,80,tcp,http,3879,29547,43,6898,34,36445,77,malware,formbook
-8530388160879243440,10.127.0.104,162.0.231.77,80,tcp,http,5654,14567,23,6602,27,21169,50,malware,formbook
-4580197808289894725,10.127.0.104,162.241.24.110,80,tcp,http,5537,2644,17,4419,21,7063,38,malware,formbook
-6223875232066022310,10.127.0.104,67.222.24.48,80,tcp,http,4258,59559,58,7298,41,66857,99,malware,formbook
5502907278230978916,10.127.0.104,49.212.180.95,80,tcp,http,6256,2320,20,6457,23,8777,43,malware,formbook
-7669545475607221732,10.127.0.104,34.120.137.41,80,tcp,http,4873,167982,136,9230,83,177212,219,malware,formbook
-258932020306830555,10.127.0.104,208.91.197.91,80,tcp,http,187,92,2,2197,4,2289,6,malware,formbook
7569446793635795400,10.127.0.71,54.209.91.188,80,tcp,http,244,524,5,439,6,963,11,malware,formbook
-5116213135590572435,10.127.0.71,204.197.253.140,80,tcp,http,2188,632,5,397,5,1029,10,malware,formbook
-3078109338840684958,10.127.0.171,212.32.237.90,80,tcp,http,109,584,5,408,5,992,10,malware,formbook
-7159030815462860189,10.127.0.171,172.82.182.134,80,tcp,http,531,1113,4,398,5,1511,9,malware,formbook
4203029779199681221,10.127.0.171,23.227.38.74,80,tcp,http,132,6480,10,672,11,7152,21,malware,formbook
427600235495439817,10.127.0.116,152.195.38.76,80,tcp,-,7,40,1,46,1,86,2,malware,formbook
-3520221219672240948,10.127.0.116,20.190.159.4,443,tcp,-,15031,0,0,260,5,260,5,malware,formbook
6844001859604540315,10.127.0.116,34.98.99.30,80,tcp,http,330,1378,10,811,10,2189,20,malware,formbook
-626693097134686028,10.127.0.116,103.193.174.99,80,tcp,http,652,707,5,398,5,1105,10,malware,formbook
48549377835889804,10.127.0.116,54.221.251.148,80,tcp,http,213,530,5,445,6,975,11,malware,formbook
8467223019154511063,10.127.0.116,185.227.152.245,80,tcp,http,586,172,4,400,5,572,9,malware,formbook
8306877405132182333,10.127.0.79,103.153.3.23,80,tcp,http,808,1290,5,431,5,1721,10,malware,formbook
4605808307768618168,10.127.0.79,154.213.25.52,80,tcp,http,6092,2000,19,6403,23,8403,42,malware,formbook
-8846445471460323535,10.127.0.79,162.213.249.254,80,tcp,http,5694,2991,19,6390,23,9381,42,malware,formbook
9084441705605676794,10.127.0.79,192.124.249.5,80,tcp,http,41466,231930,182,13114,158,245044,340,malware,formbook
-621153870035185259,10.127.0.79,148.66.54.130,80,tcp,-,29067,0,0,468,9,468,9,malware,formbook
-7048998627934988059,10.127.0.126,203.26.41.132,443,tcp,tls,30243,92,2,311,4,403,6,malware,heodo
-2274548462381085709,10.127.0.126,101.99.3.20,80,tcp,http,50806,867754,624,30583,475,898337,1099,malware,heodo
-5694290772660634759,10.127.0.114,91.121.146.47,8080,tcp,-,9305,3198,21,2031,24,5229,45,malware,heodo
-1187336062580985581,10.127.0.114,66.228.32.31,7080,tcp,tls,10872,438,10,765,13,1203,23,malware,heodo
-4607070215141658621,10.127.0.114,182.162.143.56,443,tcp,-,14735,219,5,581,10,800,15,malware,heodo
116406705367140921,10.127.0.114,187.63.160.88,80,tcp,-,5057,438,10,717,12,1155,22,malware,heodo
2029311176237133903,10.127.0.114,167.172.199.165,8080,tcp,-,7719,219,5,533,9,752,14,malware,heodo
3077902154744442658,10.127.0.114,164.90.222.65,443,tcp,tls,3863,438,10,717,12,1155,22,malware,heodo
6209749090230116444,10.127.0.114,104.168.155.143,8080,tcp,tls,4631,438,10,717,12,1155,22,malware,heodo
-1000555628498842906,10.127.0.114,163.44.196.120,8080,tcp,-,5066,240,6,304,6,544,12,malware,heodo
7130462958509676276,10.127.0.114,160.16.142.56,8080,tcp,-,3602,0,0,156,3,156,3,malware,heodo
-2027520703017584701,10.127.0.164,91.121.146.47,8080,tcp,tls,208,438,10,613,10,1051,20,malware,heodo
5131927386539741601,10.127.0.164,66.228.32.31,7080,tcp,tls,597,438,10,613,10,1051,20,malware,heodo
1712193233979068561,10.127.0.164,182.162.143.56,443,tcp,tls,1756,438,10,613,10,1051,20,malware,heodo
3861810426526858635,10.127.0.164,187.63.160.88,80,tcp,tls,1422,438,10,613,10,1051,20,malware,heodo
3122221517919174493,10.127.0.164,167.172.199.165,8080,tcp,tls,985,438,10,613,10,1051,20,malware,heodo
6823305875904160372,10.127.0.164,164.90.222.65,443,tcp,tls,147,438,10,613,10,1051,20,malware,heodo
256630143277300209,10.127.0.164,104.168.155.143,8080,tcp,tls,1002,438,10,613,10,1051,20,malware,heodo
-8525892441042106871,10.127.0.164,91.207.28.33,8080,tcp,-,0,0,0,52,1,52,1,malware,heodo
-3398734107243459200,10.127.0.138,91.121.146.47,8080,tcp,tls,93,438,10,613,10,1051,20,malware,heodo
6778360190103062067,10.127.0.138,66.228.32.31,7080,tcp,tls,475,438,10,613,10,1051,20,malware,heodo
3358626037542389027,10.127.0.138,182.162.143.56,443,tcp,tls,1680,438,10,613,10,1051,20,malware,heodo
2411963370784316480,10.127.0.138,187.63.160.88,80,tcp,tls,1337,438,10,613,10,1051,20,malware,heodo
-6137841002026965623,10.127.0.138,167.172.199.165,8080,tcp,tls,895,438,10,613,10,1051,20,malware,heodo
7183132372553886549,10.127.0.138,164.90.222.65,443,tcp,tls,48,438,10,613,10,1051,20,malware,heodo
-6845158458756396992,10.127.0.138,104.168.155.143,8080,tcp,-,3429,0,0,104,2,104,2,malware,heodo
1295001036918332653,10.127.0.138,163.44.196.120,8080,tcp,-,2556,120,3,152,3,272,6,malware,heodo
677798218329834168,10.127.0.138,160.16.142.56,8080,tcp,-,10167,0,0,152,3,152,3,malware,heodo
1474551055822667451,10.127.0.138,159.89.202.34,443,tcp,tls,1416,438,10,613,10,1051,20,malware,heodo
-2379594084150165073,10.127.0.138,159.65.88.10,8080,tcp,-,9832,0,0,152,3,152,3,malware,heodo
-7470167520548679390,10.127.0.138,186.194.240.217,443,tcp,-,2542,120,3,152,3,272,6,malware,heodo
1095246434262753174,10.127.0.119,91.121.146.47,8080,tcp,http,3293,2804,11,1275,12,4079,23,malware,heodo
3826196849690762281,10.127.0.119,66.228.32.31,7080,tcp,http,4042,2286,11,868,10,3154,21,malware,heodo
-2167397030830920227,10.127.0.119,182.162.143.56,443,tcp,-,7028,0,0,208,4,208,4,malware,heodo
-1842277493306488813,10.127.0.119,187.63.160.88,80,tcp,http,5262,2286,11,867,10,3153,21,malware,heodo
7976028556075113044,10.127.0.119,167.172.199.165,8080,tcp,http,4588,2300,11,871,10,3171,21,malware,heodo
-6769631159649452693,10.127.0.119,164.90.222.65,443,tcp,http,4468,2300,11,864,10,3164,21,malware,heodo
-5447457776556047239,10.127.0.119,104.168.155.143,8080,tcp,-,2868,200,5,260,5,460,10,malware,heodo
-3672085402886168320,10.127.0.119,91.207.28.33,8080,tcp,-,7028,0,0,208,4,208,4,malware,heodo
7777849765279719509,10.127.0.119,72.15.201.15,8080,tcp,-,7027,0,0,208,4,208,4,malware,heodo
6601195345459631804,10.127.0.119,183.111.227.137,8080,tcp,-,3469,200,5,260,5,460,10,malware,heodo
-4289538975292950749,10.127.0.119,103.132.242.26,8080,tcp,-,7027,0,0,208,4,208,4,malware,heodo
-2235477565256602238,10.127.0.119,159.65.88.10,8080,tcp,-,3011,0,0,156,3,156,3,malware,heodo
4735599820804379537,10.127.0.78,91.121.146.47,8080,tcp,-,18683,5566,22,2944,27,8510,49,malware,heodo
4844197147899660587,10.127.0.78,66.228.32.31,7080,tcp,-,3609,0,0,104,2,104,2,malware,heodo
1424462995338987547,10.127.0.78,182.162.143.56,443,tcp,tls,1910,438,10,613,10,1051,20,malware,heodo
6147939915847787089,10.127.0.78,187.63.160.88,80,tcp,tls,1521,438,10,613,10,1051,20,malware,heodo
-5498144316269357635,10.127.0.78,167.172.199.165,8080,tcp,tls,1054,438,10,613,10,1051,20,malware,heodo
1220586249504823209,10.127.0.78,164.90.222.65,443,tcp,tls,3749,219,5,429,7,648,12,malware,heodo
-4380964117975430344,10.127.0.78,104.168.155.143,8080,tcp,-,3617,0,0,104,2,104,2,malware,heodo
5030977581981803262,10.127.0.78,163.44.196.120,8080,tcp,-,2680,120,3,152,3,272,6,malware,heodo
-5284747904719229172,10.127.0.78,160.16.142.56,8080,tcp,-,10217,0,0,152,3,152,3,malware,heodo
-469711414852567648,10.127.0.162,91.121.146.47,8080,tcp,tls,7047,3531,16,1707,19,5238,35,malware,heodo
-6594463840451683698,10.127.0.162,66.228.32.31,7080,tcp,tls,561,438,10,613,10,1051,20,malware,heodo
128111154928362708,10.127.0.162,182.162.143.56,443,tcp,tls,4449,219,5,429,7,648,12,malware,heodo
5340986063175208032,10.127.0.162,187.63.160.88,80,tcp,tls,10465,219,5,477,8,696,13,malware,heodo
-8175207331875155637,10.127.0.162,167.172.199.165,8080,tcp,tls,997,438,10,613,10,1051,20,malware,heodo
-4474122973890169758,10.127.0.162,164.90.222.65,443,tcp,tls,145,438,10,613,10,1051,20,malware,heodo
-3151949590796764304,10.127.0.162,104.168.155.143,8080,tcp,-,3587,0,0,104,2,104,2,malware,heodo
-3316225020890866829,10.127.0.162,163.44.196.120,8080,tcp,-,315,40,1,52,1,92,2,malware,heodo
3571674239955346337,10.127.0.143,91.121.146.47,8080,tcp,tls,99,438,10,613,10,1051,20,malware,heodo
-669592455562022152,10.127.0.143,66.228.32.31,7080,tcp,tls,478,438,10,613,10,1051,20,malware,heodo
-4089326608122695192,10.127.0.143,182.162.143.56,443,tcp,tls,1681,438,10,613,10,1051,20,malware,heodo
634150312386104350,10.127.0.143,187.63.160.88,80,tcp,tls,1329,438,10,613,10,1051,20,malware,heodo
-7151467884856436617,10.127.0.143,167.172.199.165,8080,tcp,tls,900,438,10,613,10,1051,20,malware,heodo
-4293203353956859530,10.127.0.143,164.90.222.65,443,tcp,tls,53,438,10,613,10,1051,20,malware,heodo
-2971029970863454076,10.127.0.143,104.168.155.143,8080,tcp,-,10215,0,0,152,3,152,3,malware,heodo
2664808437681028600,10.127.0.143,91.207.28.33,8080,tcp,-,3606,0,0,104,2,104,2,malware,heodo
-8192466502737238944,10.127.0.143,72.15.201.15,8080,tcp,-,9798,0,0,152,3,152,3,malware,heodo
-2366763520466999986,10.127.0.143,183.111.227.137,8080,tcp,-,3600,0,0,104,2,104,2,malware,heodo
-8785328280545735182,10.127.0.143,103.132.242.26,8080,tcp,-,0,0,0,52,1,52,1,malware,heodo
-4785656270964584525,10.127.0.185,91.121.146.47,8080,tcp,http,8197,5401,22,2691,24,8092,46,malware,heodo
-7121509226230087976,10.127.0.10,91.121.146.47,8080,tcp,tls,218,438,10,613,10,1051,20,malware,heodo
-3058340995978624295,10.127.0.10,66.228.32.31,7080,tcp,tls,580,438,10,613,10,1051,20,malware,heodo
-3381795289233434714,10.127.0.10,182.162.143.56,443,tcp,tls,1813,438,10,613,10,1051,20,malware,heodo
1831079619013410610,10.127.0.10,187.63.160.88,80,tcp,tls,1413,438,10,613,10,1051,20,malware,heodo
6761630297672598557,10.127.0.10,167.172.199.165,8080,tcp,tls,985,438,10,613,10,1051,20,malware,heodo
3460357253567257773,10.127.0.10,164.90.222.65,443,tcp,tls,149,438,10,613,10,1051,20,malware,heodo
-3106318479059602390,10.127.0.10,104.168.155.143,8080,tcp,tls,1009,438,10,613,10,1051,20,malware,heodo
-6826131465052664251,10.127.0.10,163.44.196.120,8080,tcp,-,2331,120,3,152,3,272,6,malware,heodo
8355737884417900183,10.127.0.10,160.16.142.56,8080,tcp,-,9452,0,0,152,3,152,3,malware,heodo
5292024687036129709,10.127.0.10,159.89.202.34,443,tcp,tls,1620,438,10,613,10,1051,20,malware,heodo
1437879547063297185,10.127.0.10,159.65.88.10,8080,tcp,-,3587,0,0,104,2,104,2,malware,heodo
-8619082911574298698,10.127.0.10,186.194.240.217,443,tcp,-,2385,120,3,152,3,272,6,malware,heodo
667426698609875718,10.127.0.10,149.56.131.28,8080,tcp,-,3597,0,0,104,2,104,2,malware,heodo
-7636789487648981236,10.127.0.184,91.121.146.47,8080,tcp,tls,2493,438,10,613,10,1051,20,malware,heodo
-3129834777569332058,10.127.0.184,66.228.32.31,7080,tcp,tls,591,438,10,613,10,1051,20,malware,heodo
-6549568930130005098,10.127.0.184,182.162.143.56,443,tcp,-,10199,0,0,152,3,152,3,malware,heodo
1759585837422702847,10.127.0.184,187.63.160.88,80,tcp,tls,1432,438,10,613,10,1051,20,malware,heodo
8070847691277063957,10.127.0.184,167.172.199.165,8080,tcp,tls,983,438,10,613,10,1051,20,malware,heodo
6101792461995177747,10.127.0.184,164.90.222.65,443,tcp,-,3602,0,0,104,2,104,2,malware,heodo
-6195458468439505118,10.127.0.184,104.168.155.143,8080,tcp,-,7939,80,2,152,3,232,5,malware,heodo
5170955137912800260,10.127.0.184,91.207.28.33,8080,tcp,-,10201,0,0,152,3,152,3,malware,heodo
-5686319802505467284,10.127.0.184,72.15.201.15,8080,tcp,-,3595,0,0,104,2,104,2,malware,heodo
-2183517030358720377,10.127.0.65,91.121.146.47,8080,tcp,http,5814,3409,11,1360,12,4769,23,malware,heodo
7863533212730903927,10.127.0.15,8.8.8.8,53,udp,dns,205,222,3,174,3,396,6,normal,-
-1730371572162446615,10.127.0.15,88.99.160.97,80,tcp,http,74951,336,3,403,5,739,8,malware,heodo
-2996523109286553656,10.127.0.15,146.158.12.120,443,tcp,http,6184,210521,158,4630,86,215151,244,malware,heodo
-6017273199189073356,10.127.0.15,195.54.41.228,443,tcp,http,66225,866900,629,15771,332,882671,961,malware,heodo
-8891079759578784968,10.127.0.84,91.121.146.47,8080,tcp,tls,10248,219,5,477,8,696,13,malware,heodo
7016589735575559001,10.127.0.84,66.228.32.31,7080,tcp,-,3571,0,0,104,2,104,2,malware,heodo
579209375225690996,10.127.0.84,182.162.143.56,443,tcp,tls,1815,438,10,613,10,1051,20,malware,heodo
8320332503523685503,10.127.0.84,187.63.160.88,80,tcp,tls,4369,219,5,429,7,648,12,malware,heodo
-3325751728593459221,10.127.0.84,167.172.199.165,8080,tcp,-,3602,0,0,104,2,104,2,malware,heodo
7421361918026383483,10.127.0.84,164.90.222.65,443,tcp,-,10217,0,0,152,3,152,3,malware,heodo
365288197661477538,10.127.0.84,104.168.155.143,8080,tcp,-,10207,0,0,152,3,152,3,malware,heodo
6490524593944005996,10.127.0.84,91.207.28.33,8080,tcp,-,1387,80,2,104,2,184,4,malware,heodo
8066746694458478558,10.127.0.188,52.152.110.14,443,tcp,-,360738,0,0,6292,121,6292,121,malware,heodo
-9048752379945193804,10.127.0.188,91.121.146.47,8080,tcp,http,3557,3292,11,1391,12,4683,23,malware,heodo
-8822721000295354503,10.127.0.62,91.121.146.47,8080,tcp,http,7044,3034,11,1422,12,4456,23,malware,heodo
-4072223668263673304,10.127.0.131,8.8.8.8,53,udp,dns,8,72,1,56,1,128,2,normal,-
-2970616214697641161,10.127.0.131,185.246.88.244,80,tcp,http,65417,881158,636,15332,329,896490,965,malware,heodo
3097005983145951768,10.127.0.104,91.121.146.47,8080,tcp,http,4784,3054,11,1372,12,4426,23,malware,heodo
-1442910543206991200,10.127.0.30,91.121.146.47,8080,tcp,tls,209,438,10,613,10,1051,20,malware,heodo
4335826371155161939,10.127.0.30,66.228.32.31,7080,tcp,-,3602,0,0,104,2,104,2,malware,heodo
916092218594488899,10.127.0.30,182.162.143.56,443,tcp,tls,1758,438,10,613,10,1051,20,malware,heodo
5639569139103288441,10.127.0.30,187.63.160.88,80,tcp,tls,1420,438,10,613,10,1051,20,malware,heodo
4899980230495604299,10.127.0.30,167.172.199.165,8080,tcp,tls,993,438,10,613,10,1051,20,malware,heodo
-5447322102244593310,10.127.0.30,164.90.222.65,443,tcp,tls,3672,219,5,429,7,648,12,malware,heodo
2034388855853730015,10.127.0.30,104.168.155.143,8080,tcp,tls,10147,219,5,477,8,696,13,malware,heodo
-6878107979837390177,10.127.0.30,163.44.196.120,8080,tcp,-,2329,120,3,152,3,272,6,malware,heodo
-5793118681463727820,10.127.0.30,160.16.142.56,8080,tcp,-,3337,0,0,104,2,104,2,malware,heodo
-967982763125232677,10.127.0.30,159.89.202.34,443,tcp,-,3601,0,0,104,2,104,2,malware,heodo
-1619885401138957858,10.127.0.68,91.121.146.47,8080,tcp,http,13032,8996,33,3890,36,12886,69,malware,heodo
-3507913948965779298,10.127.0.173,91.121.146.47,8080,tcp,http,8756,3117,16,1856,19,4973,35,malware,heodo
7813409005510407222,10.127.0.186,91.121.146.47,8080,tcp,http,3666,2891,11,1323,12,4214,23,malware,heodo
4061339763893990876,10.127.0.178,178.79.208.1,80,tcp,-,113701,0,0,1932,42,1932,42,malware,heodo
-1783909970474491513,10.127.0.178,52.152.108.96,443,tcp,-,30075,0,0,520,10,520,10,malware,heodo
8921385018196872088,10.127.0.178,13.89.179.9,443,tcp,-,37905,0,0,644,14,644,14,malware,heodo
-4394660042096673117,10.127.0.178,91.121.146.47,8080,tcp,-,7021,0,0,208,4,208,4,malware,heodo
-4286062715001392067,10.127.0.178,66.228.32.31,7080,tcp,http,5314,3130,10,1304,11,4434,21,malware,heodo
-5328339133422962498,10.127.0.105,91.121.146.47,8080,tcp,-,6874,2804,11,1420,14,4224,25,malware,heodo
-2597388717994953391,10.127.0.105,66.228.32.31,7080,tcp,tls,22321,2077,11,1179,15,3256,26,malware,heodo
-6017122870555626431,10.127.0.105,182.162.143.56,443,tcp,-,9049,2286,11,966,12,3252,23,malware,heodo
-3867505678007836357,10.127.0.105,187.63.160.88,80,tcp,tls,7484,2724,21,1477,20,4201,41,malware,heodo
6793620198459174292,10.127.0.105,167.172.199.165,8080,tcp,tls,8097,438,10,821,14,1259,24,malware,heodo
-8794859344350800237,10.127.0.105,164.90.222.65,443,tcp,tls,3663,2738,21,1474,20,4212,41,malware,heodo
-7472685961257394783,10.127.0.105,104.168.155.143,8080,tcp,-,7185,2420,14,1020,13,3440,27,malware,heodo
-1836847552712912107,10.127.0.105,91.207.28.33,8080,tcp,-,3592,0,0,104,2,104,2,malware,heodo
1354264197594003837,10.127.0.105,72.15.201.15,8080,tcp,-,9158,0,0,152,3,152,3,malware,heodo
-7560856362376129775,10.127.0.99,20.189.173.11,443,tcp,-,39374,0,0,644,14,644,14,malware,heodo
-4068528667565302412,10.127.0.99,91.121.146.47,8080,tcp,http,19636,2807,11,1455,12,4262,23,malware,heodo
-7911168575372391530,10.127.0.125,91.121.146.47,8080,tcp,http,4480,2717,11,1279,12,3996,23,malware,heodo
-2772725662616323570,10.127.0.125,67.24.33.254,80,tcp,-,37906,0,0,644,14,644,14,malware,heodo
5883608249594587515,10.127.0.127,91.121.146.47,8080,tcp,tls,297,438,10,613,10,1051,20,malware,heodo
-5482321386074305455,10.127.0.127,66.228.32.31,7080,tcp,tls,653,438,10,613,10,1051,20,malware,heodo
2572471424129195525,10.127.0.127,182.162.143.56,443,tcp,tls,1837,438,10,613,10,1051,20,malware,heodo
7295948344637995067,10.127.0.127,187.63.160.88,80,tcp,tls,1506,438,10,613,10,1051,20,malware,heodo
-5682353702302604231,10.127.0.127,167.172.199.165,8080,tcp,tls,1069,438,10,613,10,1051,20,malware,heodo
-1981269344317618352,10.127.0.127,164.90.222.65,443,tcp,tls,242,438,10,613,10,1051,20,malware,heodo
-659095961224212898,10.127.0.127,104.168.155.143,8080,tcp,tls,1081,438,10,613,10,1051,20,malware,heodo
-1579888853576541265,10.127.0.127,91.207.28.33,8080,tcp,-,2458,120,3,152,3,272,6,malware,heodo
6009580279714742807,10.127.0.127,72.15.201.15,8080,tcp,-,9740,0,0,152,3,152,3,malware,heodo
6991199777807098017,10.127.0.127,183.111.227.137,8080,tcp,-,2792,120,3,152,3,272,6,malware,heodo
1831040654862338166,10.127.0.127,103.132.242.26,8080,tcp,-,3602,0,0,104,2,104,2,malware,heodo
3042282237813277885,10.127.0.127,159.65.88.10,8080,tcp,-,3602,0,0,104,2,104,2,malware,heodo
-6307535662611197823,10.127.0.128,91.121.146.47,8080,tcp,http,4880,3252,11,1354,12,4606,23,malware,heodo
7893590770908837296,10.127.0.185,52.152.108.96,443,tcp,-,30048,0,0,520,10,520,10,malware,heodo
-8814794640014079755,10.127.0.185,20.189.173.5,443,tcp,-,20202,0,0,322,7,322,7,malware,heodo
-1682939488856802040,10.127.0.185,93.184.220.29,80,tcp,-,37887,0,0,644,14,644,14,malware,heodo
2737466523504423602,10.127.0.191,91.121.146.47,8080,tcp,http,5532,3173,11,1406,12,4579,23,malware,heodo
4391394675250021223,10.127.0.25,91.121.146.47,8080,tcp,tls,190,438,10,613,10,1051,20,malware,heodo
4499992002345302273,10.127.0.25,66.228.32.31,7080,tcp,tls,3870,219,5,429,7,648,12,malware,heodo
1080257849784629233,10.127.0.25,182.162.143.56,443,tcp,tls,4467,219,5,429,7,648,12,malware,heodo
5803734770293428775,10.127.0.25,187.63.160.88,80,tcp,-,10182,0,0,152,3,152,3,malware,heodo
-1981883426949112192,10.127.0.25,167.172.199.165,8080,tcp,-,3337,0,0,104,2,104,2,malware,heodo
-5283156471054452976,10.127.0.25,164.90.222.65,443,tcp,tls,3682,219,5,429,7,648,12,malware,heodo
2198554487043870349,10.127.0.25,104.168.155.143,8080,tcp,-,3587,0,0,104,2,104,2,malware,heodo
2877098884035176616,10.127.0.25,163.44.196.120,8080,tcp,-,2504,120,3,152,3,272,6,malware,heodo
-6308352295600773223,10.127.0.93,91.121.146.47,8080,tcp,tls,10317,219,5,477,8,696,13,malware,heodo
-1801397585521124045,10.127.0.93,66.228.32.31,7080,tcp,-,3597,0,0,104,2,104,2,malware,heodo
7495037137819931829,10.127.0.93,182.162.143.56,443,tcp,-,10136,0,0,152,3,152,3,malware,heodo
-497654817572997543,10.127.0.93,187.63.160.88,80,tcp,tls,10761,219,5,477,8,696,13,malware,heodo
5813607036281363567,10.127.0.93,167.172.199.165,8080,tcp,tls,10180,219,5,477,8,696,13,malware,heodo
2463840631804304194,10.127.0.93,164.90.222.65,443,tcp,tls,244,438,10,613,10,1051,20,malware,heodo
-8452699123435205508,10.127.0.93,104.168.155.143,8080,tcp,tls,1073,438,10,613,10,1051,20,malware,heodo
-1484642900067268258,10.127.0.93,91.207.28.33,8080,tcp,-,3586,0,0,104,2,104,2,malware,heodo
-442599613549869479,10.127.0.71,91.121.146.47,8080,tcp,http,8037,3272,11,1401,14,4673,25,malware,heodo
-1337629143773608201,10.127.0.124,91.121.146.47,8080,tcp,tls,101,438,10,613,10,1051,20,malware,heodo
-3876703722328815848,10.127.0.124,66.228.32.31,7080,tcp,tls,474,438,10,613,10,1051,20,malware,heodo
-7296437874889488888,10.127.0.124,182.162.143.56,443,tcp,tls,1681,438,10,613,10,1051,20,malware,heodo
-2572960954380689346,10.127.0.124,187.63.160.88,80,tcp,tls,1330,438,10,613,10,1051,20,malware,heodo
273127984055534915,10.127.0.124,167.172.199.165,8080,tcp,tls,898,438,10,613,10,1051,20,malware,heodo
-7500314620723653226,10.127.0.124,164.90.222.65,443,tcp,tls,50,438,10,613,10,1051,20,malware,heodo
-434189472673896454,10.127.0.124,104.168.155.143,8080,tcp,tls,906,438,10,613,10,1051,20,malware,heodo
7705970023000833191,10.127.0.124,163.44.196.120,8080,tcp,-,2491,120,3,152,3,272,6,malware,heodo
4441095298761846009,10.127.0.124,160.16.142.56,8080,tcp,-,3553,0,0,104,2,104,2,malware,heodo
-3020975281604292593,10.127.0.124,159.89.202.34,443,tcp,tls,1517,438,10,613,10,1051,20,malware,heodo
-7364518409315170899,10.127.0.124,159.65.88.10,8080,tcp,-,10091,0,0,152,3,152,3,malware,heodo
8639324133646355097,10.127.0.124,186.194.240.217,443,tcp,-,2238,120,3,152,3,272,6,malware,heodo
2496735877910172862,10.127.0.124,149.56.131.28,8080,tcp,-,3555,0,0,104,2,104,2,malware,heodo
4902538961699472286,10.127.0.193,91.121.146.47,8080,tcp,http,5026,2585,11,1291,12,3876,23,malware,heodo
6050280677124414502,10.127.0.174,88.99.160.97,80,tcp,http,75141,416,5,449,6,865,11,malware,heodo
9182486522984675589,10.127.0.174,146.158.12.120,443,tcp,http,6469,211055,160,4386,84,215441,244,malware,heodo
-12625244553852310,10.127.0.174,195.54.41.228,443,tcp,http,65985,866735,631,15315,322,882050,953,malware,heodo
7132442073307839067,10.127.0.174,91.121.146.47,8080,tcp,http,4677,3274,11,1422,12,4696,23,malware,heodo
4702552501382032372,10.127.0.172,20.189.173.12,443,tcp,-,42328,0,0,644,14,644,14,malware,heodo
-7811724887778692859,10.127.0.172,91.121.146.47,8080,tcp,http,7192,5398,22,2581,24,7979,46,malware,heodo
-3968394051136252711,10.127.0.175,185.246.88.244,80,tcp,http,65605,881025,635,15066,324,896091,959,malware,heodo
9214863202909990324,10.127.0.175,91.121.146.47,8080,tcp,tls,5166,2991,11,1302,12,4293,23,malware,heodo
-2473721523372487487,10.127.0.80,91.121.146.47,8080,tcp,-,10133,0,0,152,3,152,3,malware,heodo
-2438936373966685666,10.127.0.80,66.228.32.31,7080,tcp,-,3587,0,0,104,2,104,2,malware,heodo
5615856436236815314,10.127.0.80,182.162.143.56,443,tcp,-,3586,0,0,104,2,104,2,malware,heodo
-8107410716963936760,10.127.0.80,187.63.160.88,80,tcp,-,3587,0,0,104,2,104,2,malware,heodo
-7037326073179352570,10.127.0.80,167.172.199.165,8080,tcp,tls,10581,219,5,477,8,696,13,malware,heodo
-5988735094672043815,10.127.0.80,164.90.222.65,443,tcp,tls,245,438,10,613,10,1051,20,malware,heodo
2384289050883406891,10.127.0.80,104.168.155.143,8080,tcp,-,2208,120,3,152,3,272,6,malware,heodo
8509525447165935349,10.127.0.80,91.207.28.33,8080,tcp,-,3587,0,0,104,2,104,2,malware,heodo
5595974301504649409,10.127.0.183,91.121.146.47,8080,tcp,tls,12204,219,5,477,8,696,13,malware,heodo
-2673675474858380940,10.127.0.183,66.228.32.31,7080,tcp,-,3587,0,0,104,2,104,2,malware,heodo
-6093409627419053980,10.127.0.183,182.162.143.56,443,tcp,tls,901,219,5,377,6,596,11,malware,heodo
-8764391596671443449,10.127.0.167,91.121.146.47,8080,tcp,http,4864,3212,11,1364,12,4576,23,malware,heodo
-4220281836305079048,10.127.0.105,163.44.196.120,8080,tcp,-,3100,200,5,260,5,460,10,malware,heodo
3146550575134698998,10.127.0.105,160.16.142.56,8080,tcp,-,7028,0,0,208,4,208,4,malware,heodo
-7901197852275348007,10.127.0.105,159.89.202.34,443,tcp,http,4968,2286,11,861,10,3147,21,malware,heodo
-354628207173485740,10.127.0.105,159.65.88.10,8080,tcp,-,7028,0,0,208,4,208,4,malware,heodo
-6825912818767173220,10.127.0.105,186.194.240.217,443,tcp,-,1012,0,0,104,2,104,2,malware,heodo
4678113481399479760,10.127.0.83,91.121.146.47,8080,tcp,tls,279,438,10,613,10,1051,20,malware,heodo
-5844996327184004418,10.127.0.83,66.228.32.31,7080,tcp,tls,654,438,10,613,10,1051,20,malware,heodo
6608153866003864690,10.127.0.83,182.162.143.56,443,tcp,tls,11116,219,5,477,8,696,13,malware,heodo
3442781670792398615,10.127.0.83,187.63.160.88,80,tcp,-,10185,0,0,152,3,152,3,malware,heodo
-314453445604480492,10.127.0.83,167.172.199.165,8080,tcp,tls,4122,219,5,429,7,648,12,malware,heodo
6404277120169700352,10.127.0.83,164.90.222.65,443,tcp,tls,224,438,10,613,10,1051,20,malware,heodo
-8910620018054177478,10.127.0.83,104.168.155.143,8080,tcp,tls,4140,219,5,429,7,648,12,malware,heodo
-8944921196776566891,10.127.0.83,91.207.28.33,8080,tcp,-,2108,120,3,152,3,272,6,malware,heodo
8664551546394238809,10.127.0.83,72.15.201.15,8080,tcp,-,9172,0,0,152,3,152,3,malware,heodo
4544473673719036281,10.127.0.15,91.121.146.47,8080,tcp,-,9567,0,0,152,3,152,3,malware,heodo
-7585642137518597825,10.127.0.15,66.228.32.31,7080,tcp,-,3602,0,0,104,2,104,2,malware,heodo
1281830208625362880,10.127.0.15,182.162.143.56,443,tcp,-,3587,0,0,104,2,104,2,malware,heodo
8210273800982897662,10.127.0.15,187.63.160.88,80,tcp,tls,4212,219,5,429,7,648,12,malware,heodo
8851396067570386683,10.127.0.15,167.172.199.165,8080,tcp,tls,10688,219,5,477,8,696,13,malware,heodo
-5894263648154179054,10.127.0.15,164.90.222.65,443,tcp,tls,167,438,10,613,10,1051,20,malware,heodo
255229495120689697,10.127.0.15,104.168.155.143,8080,tcp,-,2144,120,3,152,3,272,6,malware,heodo
-6825100972236556541,10.127.0.15,91.207.28.33,8080,tcp,-,3598,0,0,104,2,104,2,malware,heodo
-6667001826574193722,10.127.0.5,91.121.146.47,8080,tcp,-,7222,0,0,208,4,208,4,malware,heodo
-6632216677168391901,10.127.0.5,66.228.32.31,7080,tcp,tls,1212,876,20,1226,20,2102,40,malware,heodo
8394793243980486675,10.127.0.5,182.162.143.56,443,tcp,tls,8126,219,5,533,9,752,14,malware,heodo
6146053053543908621,10.127.0.5,187.63.160.88,80,tcp,tls,5728,657,15,1042,17,1699,32,malware,heodo
7216137697328492811,10.127.0.5,167.172.199.165,8080,tcp,tls,11166,438,10,765,13,1203,23,malware,heodo
3914864653223152027,10.127.0.5,164.90.222.65,443,tcp,tls,3770,438,10,717,12,1155,22,malware,heodo
-1808991252318299344,10.127.0.5,104.168.155.143,8080,tcp,-,13824,0,0,256,5,256,5,malware,heodo
600593045548607599,10.127.0.5,163.44.196.120,8080,tcp,-,2874,120,3,204,4,324,7,malware,heodo
-2590469501000900354,10.127.0.5,160.16.142.56,8080,tcp,-,9795,0,0,152,3,152,3,malware,heodo
6510718262260765099,10.127.0.5,159.89.202.34,443,tcp,tls,1593,438,10,613,10,1051,20,malware,heodo
5458347939391542684,10.127.0.101,91.121.146.47,8080,tcp,tls,289,438,10,613,10,1051,20,malware,heodo
2919273360836335037,10.127.0.101,66.228.32.31,7080,tcp,tls,636,438,10,613,10,1051,20,malware,heodo
-6231035989532160705,10.127.0.101,182.162.143.56,443,tcp,tls,1877,438,10,613,10,1051,20,malware,heodo
4223016128784461539,10.127.0.101,187.63.160.88,80,tcp,tls,1501,438,10,613,10,1051,20,malware,heodo
9153566807443649486,10.127.0.101,167.172.199.165,8080,tcp,tls,1073,438,10,613,10,1051,20,malware,heodo
7184511578161763276,10.127.0.101,164.90.222.65,443,tcp,tls,234,438,10,613,10,1051,20,malware,heodo
-5112739352272919589,10.127.0.101,104.168.155.143,8080,tcp,-,9623,0,0,152,3,152,3,malware,heodo
-4434194955281613322,10.127.0.101,163.44.196.120,8080,tcp,-,2680,120,3,152,3,272,6,malware,heodo
5506497184119174192,10.127.0.101,160.16.142.56,8080,tcp,-,9952,0,0,152,3,152,3,malware,heodo
-8115110971251882281,10.127.0.101,159.89.202.34,443,tcp,tls,1709,438,10,613,10,1051,20,malware,heodo
6477487962484836811,10.127.0.101,159.65.88.10,8080,tcp,-,9780,0,0,152,3,152,3,malware,heodo
-2198763320957585909,10.127.0.101,186.194.240.217,443,tcp,-,242,40,1,52,1,92,2,malware,heodo
-4330091382262097199,10.127.0.96,91.121.146.47,8080,tcp,tls,307,438,10,613,10,1051,20,malware,heodo
176863327817551979,10.127.0.96,66.228.32.31,7080,tcp,tls,10465,219,5,477,8,696,13,malware,heodo
-3242870824743121061,10.127.0.96,182.162.143.56,443,tcp,tls,1893,438,10,613,10,1051,20,malware,heodo
1480606095765678481,10.127.0.96,187.63.160.88,80,tcp,-,3588,0,0,104,2,104,2,malware,heodo
8281265937358085373,10.127.0.96,167.172.199.165,8080,tcp,-,3593,0,0,104,2,104,2,malware,heodo
581635510268376461,10.127.0.96,164.90.222.65,443,tcp,tls,3386,219,5,429,7,648,12,malware,heodo
-6474438210096529484,10.127.0.96,104.168.155.143,8080,tcp,-,3587,0,0,104,2,104,2,malware,heodo
363643761899694654,10.127.0.96,163.44.196.120,8080,tcp,-,2359,120,3,152,3,272,6,malware,heodo
5477016141119018871,10.127.0.96,160.16.142.56,8080,tcp,-,3587,0,0,104,2,104,2,malware,heodo
6617422272119820379,10.127.0.118,40.125.122.176,443,tcp,-,15013,0,0,260,5,260,5,malware,heodo
-8194381099968713932,10.127.0.118,91.121.146.47,8080,tcp,http,4883,3371,11,1382,12,4753,23,malware,heodo
-8553173283205952642,10.127.0.102,91.121.146.47,8080,tcp,http,3783,3609,21,1963,22,5572,43,malware,heodo
-4779549992263866805,10.127.0.102,13.107.4.50,80,tcp,-,18953,0,0,322,7,322,7,malware,heodo
-5345750008851598480,10.127.0.72,8.8.8.8,53,udp,dns,149,2044,14,1007,14,3051,28,normal,-
-2939842129483749748,10.127.0.72,20.189.173.6,443,tcp,-,37904,0,0,644,14,644,14,malware,heodo
634679772991844528,10.127.0.72,91.121.146.47,8080,tcp,http,4408,2869,12,1393,12,4262,24,malware,heodo
1060722694419119148,10.127.0.72,209.197.3.8,80,tcp,-,38169,0,0,644,14,644,14,malware,heodo
8037383175618485924,10.127.0.72,173.223.113.164,443,tcp,-,37904,0,0,644,14,644,14,malware,heodo
6885039519351547649,10.127.0.165,209.197.3.8,80,tcp,-,15033,0,0,260,5,260,5,malware,heodo
-8033176572629095956,10.127.0.165,91.121.146.47,8080,tcp,http,5544,3055,11,1333,12,4388,23,malware,heodo
-2877210354189861363,10.127.0.163,40.126.32.68,443,tcp,-,15030,0,0,260,5,260,5,malware,heodo
-4616264484597880399,10.127.0.163,91.121.146.47,8080,tcp,http,4558,2809,11,1351,12,4160,23,malware,heodo
533741315227445373,10.127.0.113,91.121.146.47,8080,tcp,http,3652,2576,11,1325,12,3901,23,malware,heodo
6867840684982145335,10.127.0.120,203.26.41.132,443,tcp,tls,31432,92,2,374,4,466,6,malware,heodo
-5961633396088095139,10.127.0.120,101.99.3.20,80,tcp,http,66936,867363,625,24077,416,891440,1041,malware,heodo
5698477197248353633,10.127.0.120,91.121.146.47,8080,tcp,http,5517,3355,12,1313,12,4668,24,malware,heodo
-7858655122140665299,10.127.0.112,91.121.146.47,8080,tcp,-,10193,0,0,152,3,152,3,malware,heodo
-3351700412061016121,10.127.0.112,66.228.32.31,7080,tcp,tls,710,438,10,613,10,1051,20,malware,heodo
4629280220453005630,10.127.0.112,182.162.143.56,443,tcp,tls,4539,219,5,429,7,648,12,malware,heodo
4111579930892028252,10.127.0.112,187.63.160.88,80,tcp,-,3597,0,0,104,2,104,2,malware,heodo
-6247897994311522183,10.127.0.112,167.172.199.165,8080,tcp,tls,1068,438,10,613,10,1051,20,malware,heodo
-6975311310455853499,10.127.0.112,164.90.222.65,443,tcp,tls,247,438,10,613,10,1051,20,malware,heodo
3602679506948332447,10.127.0.112,104.168.155.143,8080,tcp,tls,1096,438,10,613,10,1051,20,malware,heodo
1184944044633776093,10.127.0.112,163.44.196.120,8080,tcp,-,2425,120,3,152,3,272,6,malware,heodo
4966098609029645736,10.127.0.112,160.16.142.56,8080,tcp,-,10202,0,0,152,3,152,3,malware,heodo
8904742813738201925,10.127.0.112,159.89.202.34,443,tcp,tls,1725,438,10,613,10,1051,20,malware,heodo
-5922827951144968700,10.127.0.181,91.121.146.47,8080,tcp,http,4392,2652,11,1334,12,3986,23,malware,heodo
-8712249389912899828,10.127.0.71,66.228.32.31,7080,tcp,tls,713,438,10,613,10,1051,20,malware,heodo
6314760531235978748,10.127.0.71,182.162.143.56,443,tcp,-,3602,0,0,104,2,104,2,malware,heodo
4066020340799400694,10.127.0.71,187.63.160.88,80,tcp,tls,1491,438,10,613,10,1051,20,malware,heodo
-7580063891317744030,10.127.0.71,167.172.199.165,8080,tcp,-,3587,0,0,104,2,104,2,malware,heodo
7565407138286466802,10.127.0.71,164.90.222.65,443,tcp,-,10201,0,0,152,3,152,3,malware,heodo
-3889023965062807271,10.127.0.71,104.168.155.143,8080,tcp,-,3608,0,0,104,2,104,2,malware,heodo
-147221852372445754,10.127.0.71,163.44.196.120,8080,tcp,-,3588,0,0,104,2,104,2,malware,heodo
5589302025760195358,10.127.0.107,91.121.146.47,8080,tcp,-,10126,0,0,152,3,152,3,malware,heodo
-4933807782823288820,10.127.0.107,66.228.32.31,7080,tcp,tls,3722,219,5,429,7,648,12,malware,heodo
4362626940517767054,10.127.0.107,182.162.143.56,443,tcp,-,3586,0,0,104,2,104,2,malware,heodo
7001642120803602910,10.127.0.107,187.63.160.88,80,tcp,tls,1508,438,10,613,10,1051,20,malware,heodo
-5133840099051587596,10.127.0.107,167.172.199.165,8080,tcp,-,3587,0,0,104,2,104,2,malware,heodo
1584890466722593248,10.127.0.107,164.90.222.65,443,tcp,-,9640,0,0,152,3,152,3,malware,heodo
4716737402208267034,10.127.0.107,104.168.155.143,8080,tcp,tls,4126,219,5,429,7,648,12,malware,heodo
-8349026207866929422,10.127.0.189,40.126.31.71,443,tcp,-,15030,0,0,260,5,260,5,malware,heodo
3520897442245159669,10.127.0.189,20.190.159.64,443,tcp,-,15063,0,0,260,5,260,5,malware,heodo
953414384093407502,10.127.0.189,40.79.150.121,443,tcp,-,37904,0,0,644,14,644,14,malware,heodo
5699769470791283120,10.127.0.189,91.121.146.47,8080,tcp,http,4996,3082,12,1317,12,4399,24,malware,heodo
-5077713241576918762,10.127.0.166,93.184.220.29,80,tcp,-,18953,0,0,322,7,322,7,malware,heodo
-6545353793945869178,10.127.0.166,20.42.65.85,443,tcp,-,18953,0,0,322,7,322,7,malware,heodo
4498817018188720574,10.127.0.166,52.152.108.96,443,tcp,-,15020,0,0,260,5,260,5,malware,heodo
-5084150164378838626,10.127.0.166,91.121.146.47,8080,tcp,http,3175,2804,11,1416,12,4220,23,malware,heodo
-1020981934127374945,10.127.0.166,66.228.32.31,7080,tcp,http,4812,2286,11,857,10,3143,21,malware,heodo
5701593061252671461,10.127.0.166,182.162.143.56,443,tcp,http,5855,2286,11,854,10,3140,21,malware,heodo
8266796063849028088,10.127.0.166,187.63.160.88,80,tcp,http,6238,2286,11,856,10,3142,21,malware,heodo
-5249397331201335581,10.127.0.166,167.172.199.165,8080,tcp,http,4698,2300,11,860,10,3160,21,malware,heodo
5497716315418507123,10.127.0.166,164.90.222.65,443,tcp,http,3444,2300,11,853,10,3153,21,malware,heodo
6819889698511912577,10.127.0.166,104.168.155.143,8080,tcp,-,7025,0,0,208,4,208,4,malware,heodo
1549232783546934671,10.127.0.166,91.207.28.33,8080,tcp,-,7024,0,0,208,4,208,4,malware,heodo
-4958178134258683334,10.127.0.166,72.15.201.15,8080,tcp,-,7027,0,0,208,4,208,4,malware,heodo
-6624230541816816821,10.127.0.166,183.111.227.137,8080,tcp,-,3404,200,5,260,5,460,10,malware,heodo
-9136717759111087975,10.127.0.166,103.132.242.26,8080,tcp,-,7024,0,0,208,4,208,4,malware,heodo
2041590680599806999,10.127.0.123,91.121.146.47,8080,tcp,tls,114,438,10,613,10,1051,20,malware,heodo
7820327594961960138,10.127.0.123,66.228.32.31,7080,tcp,tls,484,438,10,613,10,1051,20,malware,heodo
8798950825385655226,10.127.0.123,182.162.143.56,443,tcp,tls,1668,438,10,613,10,1051,20,malware,heodo
3453930775643214551,10.127.0.123,187.63.160.88,80,tcp,tls,1323,438,10,613,10,1051,20,malware,heodo
-2522013869207058084,10.127.0.123,167.172.199.165,8080,tcp,tls,903,438,10,613,10,1051,20,malware,heodo
-7203998088507572031,10.127.0.123,164.90.222.65,443,tcp,tls,51,438,10,613,10,1051,20,malware,heodo
-1404833670913130793,10.127.0.123,104.168.155.143,8080,tcp,tls,944,438,10,613,10,1051,20,malware,heodo
7294262453330407133,10.127.0.123,91.207.28.33,8080,tcp,-,2075,120,3,152,3,272,6,malware,heodo
6028028745594566048,10.127.0.123,72.15.201.15,8080,tcp,-,3580,0,0,104,2,104,2,malware,heodo
-879200872033344359,10.127.0.123,183.111.227.137,8080,tcp,-,2698,120,3,152,3,272,6,malware,heodo
-295408230021752892,10.127.0.123,103.132.242.26,8080,tcp,-,10168,0,0,152,3,152,3,malware,heodo
3060730703693101126,10.127.0.123,159.65.88.10,8080,tcp,-,3038,0,0,104,2,104,2,malware,heodo
-6831984351417266975,10.127.0.98,91.121.146.47,8080,tcp,http,3701,3167,11,1353,12,4520,23,malware,heodo
5012473759879306475,10.127.0.98,8.247.210.254,80,tcp,-,56857,0,0,966,21,966,21,malware,heodo
-1966940044060747775,10.127.0.140,91.121.146.47,8080,tcp,-,3606,0,0,104,2,104,2,malware,heodo
-3190560531788921299,10.127.0.140,66.228.32.31,7080,tcp,tls,510,438,10,613,10,1051,20,malware,heodo
-5229583509154421176,10.127.0.140,182.162.143.56,443,tcp,tls,1667,438,10,613,10,1051,20,malware,heodo
1698860083203113606,10.127.0.140,187.63.160.88,80,tcp,tls,1328,438,10,613,10,1051,20,malware,heodo
-4706046938844254198,10.127.0.140,167.172.199.165,8080,tcp,tls,887,438,10,613,10,1051,20,malware,heodo
8614926435736597974,10.127.0.140,164.90.222.65,443,tcp,tls,79,438,10,613,10,1051,20,malware,heodo
1632664893061171258,10.127.0.140,104.168.155.143,8080,tcp,tls,916,438,10,613,10,1051,20,malware,heodo
5110229383693211019,10.127.0.140,91.207.28.33,8080,tcp,-,2028,120,3,152,3,272,6,malware,heodo
-5747045556725056525,10.127.0.140,72.15.201.15,8080,tcp,-,3605,0,0,104,2,104,2,malware,heodo
9209148454403002944,10.127.0.140,183.111.227.137,8080,tcp,-,2768,120,3,152,3,272,6,malware,heodo
4122801509147722322,10.127.0.140,103.132.242.26,8080,tcp,-,3602,0,0,104,2,104,2,malware,heodo
-5297664043580103187,10.127.0.140,159.65.88.10,8080,tcp,-,3587,0,0,104,2,104,2,malware,heodo
-6849455374325993493,10.127.0.220,91.121.146.47,8080,tcp,-,3481,0,0,104,2,104,2,malware,heodo
-6740858047230712443,10.127.0.220,66.228.32.31,7080,tcp,tls,3864,219,5,429,7,648,12,malware,heodo
1240122585283309308,10.127.0.220,182.162.143.56,443,tcp,tls,1682,438,10,613,10,1051,20,malware,heodo
-5437115279282585941,10.127.0.220,187.63.160.88,80,tcp,tls,4242,219,5,429,7,648,12,malware,heodo
7033684149576693040,10.127.0.220,167.172.199.165,8080,tcp,tls,4032,219,5,429,7,648,12,malware,heodo
8082275128084001795,10.127.0.220,164.90.222.65,443,tcp,-,3586,0,0,104,2,104,2,malware,heodo
5054584488564757710,10.127.0.220,104.168.155.143,8080,tcp,tls,4030,219,5,429,7,648,12,malware,heodo
-1931526539218759877,10.127.0.144,91.121.146.47,8080,tcp,tls,106,438,10,613,10,1051,20,malware,heodo
-1822929212123478827,10.127.0.144,66.228.32.31,7080,tcp,tls,479,438,10,613,10,1051,20,malware,heodo
-844305981699783739,10.127.0.144,182.162.143.56,443,tcp,-,10199,0,0,152,3,152,3,malware,heodo
-519186444175352325,10.127.0.144,187.63.160.88,80,tcp,tls,1350,438,10,613,10,1051,20,malware,heodo
-9068990816986634428,10.127.0.144,167.172.199.165,8080,tcp,tls,872,438,10,613,10,1051,20,malware,heodo
6840666388186317540,10.127.0.144,164.90.222.65,443,tcp,tls,49,438,10,613,10,1051,20,malware,heodo
7398653595710981858,10.127.0.144,104.168.155.143,8080,tcp,-,2506,120,3,152,3,272,6,malware,heodo
2892182856314745088,10.127.0.144,91.207.28.33,8080,tcp,-,10202,0,0,152,3,152,3,malware,heodo
9100940814410855997,10.127.0.144,72.15.201.15,8080,tcp,-,10200,0,0,152,3,152,3,malware,heodo
8767106221676177084,10.127.0.144,183.111.227.137,8080,tcp,-,2519,120,3,152,3,272,6,malware,heodo
-4697487827037414937,10.127.0.144,103.132.242.26,8080,tcp,-,3602,0,0,104,2,104,2,malware,heodo
2509149362753977033,10.127.0.78,209.197.3.8,80,tcp,-,33989,0,0,582,12,582,12,malware,heodo
-8083813308027229664,10.127.0.78,52.168.112.66,443,tcp,-,18951,0,0,322,7,322,7,malware,heodo
8009331831740192221,10.127.0.78,173.223.113.131,80,tcp,-,18969,0,0,322,7,322,7,malware,heodo
-6837744018165798420,10.127.0.182,91.121.146.47,8080,tcp,tls,10270,219,5,477,8,696,13,malware,heodo
-8061364505893971944,10.127.0.182,66.228.32.31,7080,tcp,-,3585,0,0,104,2,104,2,malware,heodo
-80383873379950193,10.127.0.182,182.162.143.56,443,tcp,-,9827,0,0,152,3,152,3,malware,heodo
-6757621737945845442,10.127.0.182,187.63.160.88,80,tcp,tls,4319,219,5,429,7,648,12,malware,heodo
1180490837297552886,10.127.0.133,91.121.146.47,8080,tcp,-,9561,0,0,152,3,152,3,malware,heodo
5687445547377202064,10.127.0.133,66.228.32.31,7080,tcp,tls,532,438,10,613,10,1051,20,malware,heodo
-9128181916430977340,10.127.0.133,182.162.143.56,443,tcp,tls,4427,219,5,429,7,648,12,malware,heodo
-7027058084254905855,10.127.0.133,187.63.160.88,80,tcp,tls,10370,219,5,477,8,696,13,malware,heodo
6330233058234312080,10.127.0.133,167.172.199.165,8080,tcp,tls,894,438,10,613,10,1051,20,malware,heodo
9188497589133889167,10.127.0.133,164.90.222.65,443,tcp,tls,92,438,10,613,10,1051,20,malware,heodo
3464641683592437796,10.127.0.133,104.168.155.143,8080,tcp,tls,4017,219,5,429,7,648,12,malware,heodo
5874225981459344739,10.127.0.133,163.44.196.120,8080,tcp,-,2143,120,3,152,3,272,6,malware,heodo
2683163434909836786,10.127.0.133,160.16.142.56,8080,tcp,-,3574,0,0,104,2,104,2,malware,heodo
-7749180644483147787,10.127.0.173,66.228.32.31,7080,tcp,-,3586,0,0,104,2,104,2,malware,heodo
7277829276665730789,10.127.0.173,182.162.143.56,443,tcp,tls,1767,438,10,613,10,1051,20,malware,heodo
-2095573853922371746,10.127.0.173,187.63.160.88,80,tcp,-,3587,0,0,104,2,104,2,malware,heodo
-1025489210137787556,10.127.0.173,167.172.199.165,8080,tcp,tls,10662,219,5,477,8,696,13,malware,heodo
2162683720166616360,10.127.0.2,91.121.146.47,8080,tcp,tls,156,438,10,613,10,1051,20,malware,heodo
-2152395153040231358,10.127.0.2,66.228.32.31,7080,tcp,tls,565,438,10,613,10,1051,20,malware,heodo
-8145989033561913866,10.127.0.2,182.162.143.56,443,tcp,-,3605,0,0,104,2,104,2,malware,heodo
-3422512113053114324,10.127.0.2,187.63.160.88,80,tcp,tls,1425,438,10,613,10,1051,20,malware,heodo
-4162101021660798466,10.127.0.2,167.172.199.165,8080,tcp,tls,974,438,10,613,10,1051,20,malware,heodo
-1303836490761221379,10.127.0.2,164.90.222.65,443,tcp,tls,144,438,10,613,10,1051,20,malware,heodo
-7027692396302672750,10.127.0.2,104.168.155.143,8080,tcp,-,2147,120,3,152,3,272,6,malware,heodo
-5252320022632793831,10.127.0.2,91.207.28.33,8080,tcp,-,3587,0,0,104,2,104,2,malware,heodo
1799257762548725870,10.127.0.2,72.15.201.15,8080,tcp,-,9628,0,0,152,3,152,3,malware,heodo
6292742929995510254,10.127.0.2,183.111.227.137,8080,tcp,-,2545,120,3,152,3,272,6,malware,heodo
-2379281862303678771,10.127.0.2,103.132.242.26,8080,tcp,-,3586,0,0,104,2,104,2,malware,heodo
4080113698806279461,10.127.0.92,91.121.146.47,8080,tcp,tls,266,438,10,613,10,1051,20,malware,heodo
-6717784297607900071,10.127.0.92,66.228.32.31,7080,tcp,tls,660,438,10,613,10,1051,20,malware,heodo
-69021479917332894,10.127.0.92,182.162.143.56,443,tcp,-,3602,0,0,104,2,104,2,malware,heodo
-5414041529659773569,10.127.0.92,187.63.160.88,80,tcp,-,10077,0,0,152,3,152,3,malware,heodo
-483490851000585622,10.127.0.92,167.172.199.165,8080,tcp,-,9943,0,0,152,3,152,3,malware,heodo
1945811302701896296,10.127.0.92,164.90.222.65,443,tcp,tls,3733,219,5,429,7,648,12,malware,heodo
1049275157341908222,10.127.0.92,104.168.155.143,8080,tcp,-,3603,0,0,104,2,104,2,malware,heodo
-7733247426977498858,10.127.0.92,91.207.28.33,8080,tcp,-,2495,120,3,152,3,272,6,malware,heodo
-2839943559708422072,10.127.0.92,72.15.201.15,8080,tcp,-,0,0,0,52,1,52,1,malware,heodo
7354496211948391327,10.127.0.102,66.228.32.31,7080,tcp,tls,652,438,10,613,10,1051,20,malware,heodo
3934762059387718287,10.127.0.102,182.162.143.56,443,tcp,tls,5812,478,11,751,13,1229,24,malware,heodo
7815419152811109037,10.127.0.102,187.63.160.88,80,tcp,tls,1519,438,10,613,10,1051,20,malware,heodo
7154463895720092551,10.127.0.102,167.172.199.165,8080,tcp,tls,1078,438,10,613,10,1051,20,malware,heodo
7759268394399215809,10.127.0.102,164.90.222.65,443,tcp,tls,231,438,10,613,10,1051,20,malware,heodo
4288872521078218267,10.127.0.102,104.168.155.143,8080,tcp,-,10029,0,0,152,3,152,3,malware,heodo
6828431070316838322,10.127.0.102,91.207.28.33,8080,tcp,-,10155,0,0,152,3,152,3,malware,heodo
-4028843870101429222,10.127.0.102,72.15.201.15,8080,tcp,-,10025,0,0,152,3,152,3,malware,heodo
8353490413065620779,10.127.0.102,183.111.227.137,8080,tcp,-,2770,120,3,152,3,272,6,malware,heodo
-3778885820824516668,10.127.0.102,103.132.242.26,8080,tcp,-,0,0,0,52,1,52,1,malware,heodo
1083365643412609280,10.127.0.178,45.12.253.56,80,tcp,-,46673,376,4,972,11,1348,15,malware,gcleaner
9210217946605602964,10.127.0.178,45.12.253.72,80,tcp,http,31542,98942,76,4375,78,103317,154,malware,gcleaner
-6829313412801177090,10.127.0.178,45.12.253.75,80,tcp,http,31184,3166,23,5347,25,8513,48,malware,gcleaner
-4901254842992138449,10.127.0.119,45.12.253.56,80,tcp,http,38885,1200,9,1383,11,2583,20,malware,gcleaner
3225597460200855235,10.127.0.119,45.12.253.72,80,tcp,http,37903,98942,76,2857,45,101799,121,malware,gcleaner
5632810174503626797,10.127.0.119,45.12.253.75,80,tcp,http,37208,5840,34,5413,25,11253,59,malware,gcleaner
-2364213018008596331,10.127.0.111,45.12.253.56,80,tcp,-,119128,996,9,1842,20,2838,29,malware,gcleaner
32064087376574651,10.127.0.111,45.12.253.72,80,tcp,-,84113,197884,152,7584,130,205468,282,malware,gcleaner
-6610840033272962648,10.127.0.111,52.178.17.3,443,tcp,-,18952,0,0,322,7,322,7,malware,gcleaner
7484680244006031790,10.127.0.111,52.152.108.96,443,tcp,-,15038,0,0,260,5,260,5,malware,gcleaner
8169851999487168915,10.127.0.111,45.12.253.75,80,tcp,http,67929,9006,57,10760,50,19766,107,malware,gcleaner
5629834056903761401,10.127.0.141,45.12.253.56,80,tcp,http,188,336,3,619,4,955,7,malware,gcleaner
-8009517727142945331,10.127.0.136,45.12.253.56,80,tcp,http,38184,376,4,712,6,1088,10,malware,gcleaner
-8187100349718783817,10.127.0.136,45.12.253.72,80,tcp,http,37549,98982,77,2857,45,101839,122,malware,gcleaner
2968333770181005412,10.127.0.136,45.12.253.75,80,tcp,http,36585,5840,34,5413,25,11253,59,malware,gcleaner
6046644547344613763,10.127.0.127,45.12.253.56,80,tcp,http,37845,620,5,718,6,1338,11,malware,gcleaner
-4273247223171944169,10.127.0.127,45.12.253.72,80,tcp,http,37237,98942,76,2857,45,101799,121,malware,gcleaner
-8025572083874090478,10.127.0.127,45.12.253.75,80,tcp,http,36597,5840,34,5413,25,11253,59,malware,gcleaner
3874990316885990631,10.127.0.32,45.12.253.56,80,tcp,-,58505,620,5,1022,12,1642,17,malware,gcleaner
7603485237094616187,10.127.0.32,45.12.253.72,80,tcp,http,38100,98942,76,2857,45,101799,121,malware,gcleaner
8201024399005119417,10.127.0.32,45.12.253.75,80,tcp,http,37277,5354,32,5401,25,10755,57,malware,gcleaner
6485340713006334061,10.127.0.126,45.12.253.56,80,tcp,http,62999,712,7,1897,21,2609,28,malware,gcleaner
-3834551057510223871,10.127.0.126,45.12.253.72,80,tcp,http,31042,98942,76,4375,78,103317,154,malware,gcleaner
4303236854600370393,10.127.0.126,45.12.253.75,80,tcp,http,30888,3166,23,5347,25,8513,48,malware,gcleaner
-7681224618353537815,10.127.0.126,52.109.77.0,443,tcp,-,0,40,1,0,0,40,1,malware,gcleaner
4961613894269933689,10.127.0.71,45.12.253.56,80,tcp,http,441,580,4,671,5,1251,9,malware,gcleaner
3401490416509466189,10.127.0.188,45.12.253.56,80,tcp,http,125438,620,5,948,11,1568,16,malware,gcleaner
-3822121494701229122,10.127.0.188,45.12.253.72,80,tcp,http,124702,98982,77,3225,53,102207,130,malware,gcleaner
-7559508100667916043,10.127.0.175,88.221.134.32,80,tcp,http,1,1248,1,46,1,1294,2,malware,gcleaner
3218361925655098701,10.127.0.175,45.12.253.56,80,tcp,http,31623,376,4,712,6,1088,10,malware,gcleaner
9200316878084178086,10.127.0.175,45.12.253.72,80,tcp,http,31474,98942,76,4375,78,103317,154,malware,gcleaner
-1108639283514779266,10.127.0.175,45.12.253.75,80,tcp,http,31203,3166,23,5347,25,8513,48,malware,gcleaner
7257911296044253459,10.127.0.175,13.107.4.50,80,tcp,-,0,80,2,0,0,80,2,malware,gcleaner
597996807134270181,10.127.0.189,117.18.237.29,80,tcp,-,30129,0,0,520,10,520,10,malware,gcleaner
-296731806463608503,10.127.0.189,45.12.253.56,80,tcp,http,35258,712,7,1377,11,2089,18,malware,gcleaner
5685223145965470882,10.127.0.189,45.12.253.72,80,tcp,http,31527,98942,76,4375,78,103317,154,malware,gcleaner
7663473483071147275,10.127.0.189,45.12.253.75,80,tcp,http,31284,3166,23,5347,25,8513,48,malware,gcleaner
6897414720472363227,10.127.0.164,8.247.211.254,80,tcp,-,181627,0,0,3096,66,3096,66,malware,gcleaner
-5878400891851599337,10.127.0.164,40.126.32.140,443,tcp,-,15015,0,0,260,5,260,5,malware,gcleaner
215322816321573676,10.127.0.164,20.189.173.13,443,tcp,-,41139,0,0,644,14,644,14,malware,gcleaner
4871404676434027718,10.127.0.164,131.253.33.203,80,tcp,-,37906,0,0,644,14,644,14,malware,gcleaner
3627521796159305490,10.127.0.62,45.12.253.56,80,tcp,http,31276,376,4,712,6,1088,10,malware,gcleaner
-532832399352334571,10.127.0.62,45.12.253.72,80,tcp,http,31220,98942,76,4375,78,103317,154,malware,gcleaner
-699479413010572477,10.127.0.62,45.12.253.75,80,tcp,http,30962,3166,23,5347,25,8513,48,malware,gcleaner
3538898237352657450,10.127.0.11,45.12.253.56,80,tcp,http,38735,620,5,718,6,1338,11,malware,gcleaner
-8925890883927814781,10.127.0.11,45.12.253.72,80,tcp,http,38006,98942,76,2949,47,101891,123,malware,gcleaner
4453074238252556403,10.127.0.11,45.12.253.75,80,tcp,http,36839,5840,34,5413,25,11253,59,malware,gcleaner
-8364417084490268688,10.127.0.83,45.12.253.56,80,tcp,http,39875,620,5,718,6,1338,11,malware,gcleaner
-237564781297275004,10.127.0.83,45.12.253.72,80,tcp,http,39156,98942,76,3405,52,102347,128,malware,gcleaner
-404211794955512910,10.127.0.83,45.12.253.75,80,tcp,http,37907,5840,34,5459,26,11299,60,malware,gcleaner
-3360178088851640281,10.127.0.167,45.12.253.56,80,tcp,http,94096,1332,12,2095,17,3427,29,malware,gcleaner
812103311185170772,10.127.0.167,45.12.253.72,80,tcp,http,78837,197884,152,8080,137,205964,289,malware,gcleaner
3219316025487942334,10.127.0.167,45.12.253.75,80,tcp,http,68008,9006,57,10760,50,19766,107,malware,gcleaner
-1012890912924517208,10.127.0.193,152.195.38.76,80,tcp,-,2,120,3,138,3,258,6,malware,gcleaner
-3249347343086714169,10.127.0.70,45.12.253.56,80,tcp,http,39161,620,5,718,6,1338,11,malware,gcleaner
4877504960106279515,10.127.0.70,45.12.253.72,80,tcp,http,38430,98942,76,3325,54,102267,130,malware,gcleaner
7284717674409051077,10.127.0.70,45.12.253.75,80,tcp,http,37447,5840,34,5413,25,11253,59,malware,gcleaner
5937954823047248541,10.127.0.113,45.12.253.56,80,tcp,http,1763,336,3,665,5,1001,8,malware,gcleaner
-545143854248836077,10.127.0.63,45.12.253.56,80,tcp,http,30596,376,4,712,6,1088,10,malware,gcleaner
-2547224131848033223,10.127.0.63,45.12.253.72,80,tcp,http,30555,98942,76,4375,78,103317,154,malware,gcleaner
5590563780262561041,10.127.0.63,45.12.253.75,80,tcp,http,30454,2922,22,5301,24,8223,46,malware,gcleaner
544221468001173282,10.127.0.81,45.12.253.56,80,tcp,http,70282,996,9,1430,12,2426,21,malware,gcleaner
-1457858809598023864,10.127.0.81,45.12.253.72,80,tcp,http,69487,198613,153,7330,125,205943,278,malware,gcleaner
7123715582340755897,10.127.0.81,45.12.253.75,80,tcp,http,68484,8763,56,10754,50,19517,106,malware,gcleaner
2187250231253135139,10.127.0.118,40.126.32.74,443,tcp,-,15047,0,0,260,5,260,5,malware,gcleaner
1335684840254500756,10.127.0.99,45.12.253.56,80,tcp,http,33781,712,7,1377,11,2089,18,malware,gcleaner
1647500205416708052,10.127.0.99,45.12.253.72,80,tcp,http,31741,98942,76,4375,78,103317,154,malware,gcleaner
-2991316368915377211,10.127.0.99,45.12.253.75,80,tcp,http,31576,3166,23,5347,25,8513,48,malware,gcleaner
-6466212692107459271,10.127.0.162,45.12.253.56,80,tcp,http,94303,996,9,1476,13,2472,22,malware,gcleaner
1660639611085534413,10.127.0.162,45.12.253.72,80,tcp,http,84434,197884,152,7492,128,205376,280,malware,gcleaner
-6932747866402733481,10.127.0.162,45.12.253.75,80,tcp,http,68165,9249,58,10812,51,20061,109,malware,gcleaner
-3759243960960241013,10.127.0.129,45.12.253.56,80,tcp,http,337,336,3,665,5,1001,8,malware,gcleaner
-3945333287210996369,10.127.0.188,162.19.139.184,2222,tcp,-,0,390,1,46,1,436,2,malware,gcleaner
-6829113964693103298,10.127.0.33,45.12.253.56,80,tcp,http,225,336,3,619,4,955,7,malware,gcleaner
3765035642233742837,10.127.0.67,45.12.253.56,80,tcp,http,31052,324,3,712,6,1036,9,malware,gcleaner
-7935567303477988258,10.127.0.67,45.12.253.72,80,tcp,http,31006,73237,57,3777,65,77014,122,malware,gcleaner
-8102214317136226164,10.127.0.67,45.12.253.75,80,tcp,http,30754,3166,23,5347,25,8513,48,malware,gcleaner
-8428072213945769516,10.127.0.29,45.12.253.56,80,tcp,http,38585,620,5,718,6,1338,11,malware,gcleaner
-8190069026473041449,10.127.0.29,45.12.253.72,80,tcp,http,37901,99447,77,2955,47,102402,124,malware,gcleaner
-4940036485084861095,10.127.0.29,45.12.253.75,80,tcp,http,37153,5840,34,5413,25,11253,59,malware,gcleaner
1703377306765670424,10.127.0.109,45.12.253.56,80,tcp,http,1482,336,3,665,5,1001,8,malware,gcleaner
-252618976877315354,10.127.0.73,45.12.253.56,80,tcp,http,30881,376,4,712,6,1088,10,malware,gcleaner
3475875943331310202,10.127.0.73,45.12.253.72,80,tcp,http,30821,98942,76,4387,78,103329,154,malware,gcleaner
-8165298033091101724,10.127.0.73,45.12.253.75,80,tcp,http,30716,3166,23,5347,25,8513,48,malware,gcleaner
-7344053368641394815,10.127.0.120,45.12.253.56,80,tcp,http,38383,620,5,718,6,1338,11,malware,gcleaner
-1362098416212315430,10.127.0.120,45.12.253.72,80,tcp,http,37708,98982,77,3179,52,102161,129,malware,gcleaner
-764559254301812200,10.127.0.120,45.12.253.75,80,tcp,http,37115,5840,34,5413,25,11253,59,malware,gcleaner
-3954910596655084624,10.127.0.123,45.12.253.56,80,tcp,http,38456,620,5,718,6,1338,11,malware,gcleaner
2027044355773994761,10.127.0.123,45.12.253.72,80,tcp,http,37656,98982,77,2811,44,101793,121,malware,gcleaner
5277076897162175115,10.127.0.123,45.12.253.75,80,tcp,http,36831,5840,34,5413,25,11253,59,malware,gcleaner
-400526975750242214,10.127.0.183,45.12.253.56,80,tcp,http,637,580,4,671,5,1251,9,malware,gcleaner
81184942477763454,10.127.0.177,162.19.139.184,2222,tcp,-,1,390,1,46,1,436,2,malware,gcleaner
381979357563369187,10.127.0.177,45.12.253.56,80,tcp,http,31829,376,4,712,6,1088,10,malware,gcleaner
204396734987530701,10.127.0.177,45.12.253.72,80,tcp,http,31744,98942,76,4375,78,103317,154,malware,gcleaner
2611609449290302263,10.127.0.177,45.12.253.75,80,tcp,http,30983,3166,23,5347,25,8513,48,malware,gcleaner
4451711589366713031,10.127.0.70,40.77.2.164,443,tcp,-,37299,0,0,552,12,552,12,malware,gcleaner
2782826516622746999,10.127.0.70,93.184.221.240,80,tcp,-,82980,0,0,1424,29,1424,29,malware,gcleaner
6614056891844701075,10.127.0.70,93.184.220.29,80,tcp,-,15018,0,0,260,5,260,5,malware,gcleaner
-4816010439957338737,10.127.0.133,45.12.253.56,80,tcp,http,60015,376,4,712,6,1088,10,malware,gcleaner
-3661375247709722649,10.127.0.133,45.12.253.72,80,tcp,-,46751,98942,76,3101,50,102043,126,malware,gcleaner
-3901834439057439784,10.127.0.133,45.12.253.75,80,tcp,http,36520,5840,34,5413,25,11253,59,malware,gcleaner
-8649584511855533947,10.127.0.124,45.12.253.56,80,tcp,http,31688,376,4,712,6,1088,10,malware,gcleaner
-2667629559426454562,10.127.0.124,45.12.253.72,80,tcp,http,31599,98942,76,4375,78,103317,154,malware,gcleaner
-2070090397515951332,10.127.0.124,45.12.253.75,80,tcp,http,31380,3409,24,5399,26,8808,50,malware,gcleaner
-7701883763129510133,10.127.0.111,8.241.131.126,80,tcp,-,1,40,1,46,1,86,2,malware,gcleaner
3220696477461082791,10.127.0.65,45.12.253.56,80,tcp,http,33634,376,4,712,6,1088,10,malware,gcleaner
9202651429890162176,10.127.0.65,45.12.253.72,80,tcp,http,33549,98942,76,4375,78,103317,154,malware,gcleaner
6782544384011470441,10.127.0.65,45.12.253.75,80,tcp,http,33326,3166,23,5347,25,8513,48,malware,gcleaner
1741855240242300027,10.127.0.110,45.12.253.56,80,tcp,http,560,580,4,671,5,1251,9,malware,gcleaner
5840745494125290651,10.127.0.14,45.12.253.56,80,tcp,http,38680,620,5,718,6,1338,11,malware,gcleaner
3838665216526093505,10.127.0.14,45.12.253.72,80,tcp,http,38015,98982,77,2995,48,101977,125,malware,gcleaner
7948070047791025909,10.127.0.14,45.12.253.75,80,tcp,http,37278,5840,34,5413,25,11253,59,malware,gcleaner
5760540411704786906,10.127.0.31,45.12.253.56,80,tcp,http,361,580,4,671,5,1251,9,malware,gcleaner
-6602487980692080801,10.127.0.77,45.12.253.56,80,tcp,-,32272,336,3,1185,15,1521,18,malware,gcleaner
6469481196915850061,10.127.0.77,173.223.113.99,80,tcp,-,0,80,2,92,2,172,4,malware,gcleaner
-6643310805077303161,10.127.0.164,45.12.253.56,80,tcp,http,31451,376,4,712,6,1088,10,malware,gcleaner
4531327997049834555,10.127.0.164,45.12.253.72,80,tcp,http,31401,98942,76,4375,78,103317,154,malware,gcleaner
-7109845979372577371,10.127.0.164,45.12.253.75,80,tcp,http,31296,3166,23,5347,25,8513,48,malware,gcleaner
6204134216096630798,10.127.0.164,20.189.173.14,443,tcp,-,18954,0,0,322,7,322,7,malware,gcleaner
-611136945367841993,10.127.0.164,93.184.221.240,80,tcp,-,57061,0,0,966,21,966,21,malware,gcleaner
-407199251494696265,10.127.0.107,45.12.253.56,80,tcp,http,51570,376,4,712,6,1088,10,malware,gcleaner
1989077853890474717,10.127.0.107,45.12.253.72,80,tcp,http,51436,98942,76,4375,78,103317,154,malware,gcleaner
-8319878307708482635,10.127.0.107,45.12.253.75,80,tcp,-,43196,2883,21,5134,28,8017,49,malware,gcleaner
-4360933226179920272,10.127.0.107,8.238.23.254,80,tcp,-,15030,0,0,260,5,260,5,malware,gcleaner
-7984266384132958565,10.127.0.6,45.12.253.56,80,tcp,http,60155,620,5,718,6,1338,11,malware,gcleaner
142585919060035119,10.127.0.6,45.12.253.72,80,tcp,http,59431,99447,77,3139,51,102586,128,malware,gcleaner
-6305904207664318476,10.127.0.6,45.12.253.75,80,tcp,-,46373,5597,33,5559,28,11156,61,malware,gcleaner
-6820615389835286482,10.127.0.168,45.12.253.56,80,tcp,http,349,580,4,671,5,1251,9,malware,gcleaner
-7895206589662456624,10.127.0.81,117.18.232.240,80,tcp,-,139696,0,0,920,20,920,20,malware,gcleaner
-5249076654775837051,10.127.0.81,52.182.143.208,443,tcp,-,18952,0,0,322,7,322,7,malware,gcleaner
243427052915567549,10.127.0.81,162.19.139.184,2222,tcp,-,0,389,1,46,1,435,2,malware,gcleaner
-5884029101022018478,10.127.0.81,173.223.113.164,443,tcp,-,18952,0,0,322,7,322,7,malware,gcleaner
-5984617411867185330,10.127.0.81,173.223.113.131,80,tcp,-,18952,0,0,322,7,322,7,malware,gcleaner
-2560087999663897516,10.127.0.80,20.224.151.203,443,tcp,-,0,40,1,0,0,40,1,malware,gcleaner
2930491984447315681,10.127.0.80,45.12.253.56,80,tcp,http,1581,336,3,665,5,1001,8,malware,gcleaner
9182345975901602890,10.127.0.181,152.195.38.76,80,tcp,-,1,40,1,46,1,86,2,malware,gcleaner
7476631954394850502,10.127.0.167,52.109.77.0,443,tcp,-,0,40,1,0,0,40,1,malware,gcleaner
2089755349606395401,10.127.0.50,45.12.253.56,80,tcp,-,31188,376,4,971,11,1347,15,malware,gcleaner
5260118583895770126,10.127.0.163,45.12.253.56,80,tcp,http,31366,376,4,712,6,1088,10,malware,gcleaner
8988613504104395682,10.127.0.163,45.12.253.72,80,tcp,http,31262,98942,76,4375,78,103317,154,malware,gcleaner
-7050917855302384372,10.127.0.163,45.12.253.75,80,tcp,http,31023,3166,23,5347,25,8513,48,malware,gcleaner
5194854807784014542,10.127.0.207,45.12.253.56,80,tcp,http,38336,620,5,718,6,1338,11,malware,gcleaner
6349490000031630630,10.127.0.207,45.12.253.72,80,tcp,http,37689,98942,76,2949,47,101891,123,malware,gcleaner
8756702714334402192,10.127.0.207,45.12.253.75,80,tcp,http,37082,5840,34,5413,25,11253,59,malware,gcleaner
-4123652954751653908,10.127.0.108,173.223.113.131,443,tcp,tls,192438,355349,325,13748,217,369097,542,normal,-
-3984192005916813711,10.127.0.177,95.101.74.152,443,tcp,tls,325,438,10,635,10,1073,20,malware,trickbot
5141686528638427599,10.127.0.173,20.190.159.75,443,tcp,-,15015,0,0,260,5,260,5,malware,trickbot
-4873827054992536075,10.127.0.73,192.229.221.95,80,tcp,-,4,120,3,138,3,258,6,malware,trickbot
6527141951032580220,10.127.0.73,186.75.241.230,80,tcp,-,15030,0,0,260,5,260,5,malware,trickbot
-5148568379339350200,10.127.0.73,181.143.194.138,443,tcp,-,15031,0,0,260,5,260,5,malware,trickbot
-5984932082229206323,10.127.0.73,85.104.59.244,20,tcp,-,15040,0,0,260,5,260,5,malware,trickbot
730874139633222791,10.127.0.73,80.11.163.139,443,tcp,-,15047,0,0,260,5,260,5,malware,trickbot
-6170133594482030416,10.127.0.73,167.71.10.37,8080,tcp,-,15016,0,0,260,5,260,5,malware,trickbot
2783836386987696842,10.127.0.59,93.184.221.240,80,tcp,-,67985,0,0,1164,24,1164,24,malware,trickbot
8095661816774108268,10.127.0.59,20.189.173.4,443,tcp,-,19437,0,0,322,7,322,7,malware,trickbot
-7213135306951026483,10.127.0.163,64.185.227.155,443,tcp,http,100609,6927,11,1011,11,7938,22,malware,trickbot
3494301936407746446,10.127.0.100,8.255.131.126,80,tcp,-,0,40,1,46,1,86,2,malware,trickbot
-9210886646966116473,10.127.0.100,52.242.101.226,443,tcp,-,30083,0,0,520,10,520,10,malware,trickbot
4655573219864897193,10.127.0.100,8.241.136.126,80,tcp,-,1,40,1,46,1,86,2,malware,trickbot
1507453008826209330,10.127.0.100,52.242.97.97,443,tcp,-,15025,0,0,260,5,260,5,malware,trickbot
1578011336793957259,10.127.0.190,117.18.237.29,80,tcp,-,52646,0,0,322,7,322,7,malware,trickbot
4506264163053720343,10.127.0.190,13.89.178.26,443,tcp,-,18953,0,0,322,7,322,7,malware,trickbot
-8282470106456793964,10.127.0.190,95.101.78.106,80,tcp,-,18953,0,0,322,7,322,7,malware,trickbot
5847421284744269473,10.127.0.190,209.197.3.8,80,tcp,-,18953,0,0,322,7,322,7,malware,trickbot
1348940715201522173,10.127.0.190,204.79.197.203,80,tcp,-,18953,0,0,322,7,322,7,malware,trickbot
-844395405824991278,10.127.0.93,8.8.8.8,53,udp,dns,11506,2403,30,2243,35,4646,65,normal,-
2718975893936267050,10.127.0.118,40.125.122.151,443,tcp,-,15055,0,0,260,5,260,5,malware,trickbot
8082006006518875855,10.127.0.82,8.8.8.8,53,udp,dns,656,2009,16,1033,16,3042,32,normal,-
1451262744323717909,10.127.0.220,120.79.51.185,53,udp,-,0,0,0,400,5,400,5,malware,trickbot
-3654092073549711070,10.127.0.130,8.8.8.8,53,udp,dns,47,492,4,248,4,740,8,normal,-
150041007134586418,10.127.0.172,95.101.74.152,443,tcp,http,60725,5390,13,1070,12,6460,25,malware,trickbot
-5671485351436797161,10.127.0.172,23.72.252.168,443,tcp,http,60264,142927,110,3166,59,146093,169,normal,-
-5241992515283942998,10.127.0.180,153.235.85.13,80,tcp,-,62160,3360,84,4472,86,7832,170,malware,trickbot
-4352337634695368059,10.127.0.193,40.126.32.76,443,tcp,-,15012,0,0,260,5,260,5,malware,trickbot
-2954417363998029369,10.127.0.193,194.5.250.119,443,tcp,-,30047,0,0,520,10,520,10,malware,trickbot
8693471356262409970,10.127.0.201,95.101.74.152,443,tcp,tls,127,438,10,635,10,1073,20,malware,trickbot
5430858130559203496,10.127.0.201,153.235.85.13,80,tcp,-,43023,1840,46,2384,47,4224,93,malware,trickbot
5966940144468066789,10.127.0.165,20.224.254.73,443,tcp,-,0,40,1,0,0,40,1,malware,trickbot
3381535992754251719,10.127.0.165,192.229.221.95,80,tcp,-,1,40,1,46,1,86,2,malware,trickbot
-4588923936272482569,10.127.0.79,20.42.65.90,443,tcp,-,18952,0,0,322,7,322,7,malware,trickbot
-137151725460586143,10.127.0.79,13.107.4.50,80,tcp,-,38093,0,0,644,14,644,14,malware,trickbot
-7741981709116641732,10.127.0.79,178.79.208.1,80,tcp,-,18952,0,0,322,7,322,7,malware,trickbot
6521559724985387215,10.127.0.185,51.11.192.48,443,tcp,-,18949,0,0,322,7,322,7,malware,trickbot
-8922275015357350365,10.127.0.185,8.238.177.126,80,tcp,-,37905,0,0,644,14,644,14,malware,trickbot
-1684442203979730471,10.127.0.185,187.110.100.122,449,tcp,-,30054,0,0,520,10,520,10,malware,trickbot
-7747797173808957182,10.127.0.188,173.223.113.131,443,tcp,http,252804,469024,392,21170,402,490194,794,normal,-
-7363833783825674006,10.127.0.20,186.75.241.230,80,tcp,-,19511,0,0,304,6,304,6,malware,trickbot
-7638829329122909635,10.127.0.20,181.143.194.138,443,tcp,-,20335,0,0,304,6,304,6,malware,trickbot
2525407159778273698,10.127.0.20,85.104.59.244,20,tcp,-,10197,0,0,152,3,152,3,malware,trickbot
3287308567342794149,10.127.0.102,35.188.105.97,9919,tcp,-,6817,344,8,2508,10,2852,18,malware,trickbot
453857174227327561,10.127.0.102,35.188.105.97,9920,tcp,-,3365,172,4,1414,5,1586,9,malware,trickbot
-6747330861830530561,10.127.0.95,8.8.8.8,53,udp,dns,11437,2246,28,2273,35,4519,63,normal,-
-4345601851428778892,10.127.0.103,95.101.74.152,443,tcp,http,60381,5390,13,1029,11,6419,24,malware,trickbot
-4496988622733290382,10.127.0.103,23.72.252.168,443,tcp,http,60129,142746,109,3166,59,145912,168,normal,-
-7179252699934890197,10.127.0.103,153.235.85.13,80,tcp,-,64714,3560,89,4680,90,8240,179,malware,trickbot
-8788553061616825997,10.127.0.98,40.126.31.67,443,tcp,-,15031,0,0,260,5,260,5,malware,trickbot
4037075157573575875,10.127.0.84,95.101.74.152,443,tcp,tls,279,438,10,635,10,1073,20,malware,trickbot
5292828550851294706,10.127.0.30,8.8.8.8,53,udp,dns,241,577,6,352,6,929,12,normal,-
1113942257005612802,10.127.0.30,31.31.196.244,80,tcp,-,0,0,0,52,1,52,1,malware,trickbot
94495163527436994,10.127.0.30,208.67.104.60,80,tcp,-,0,0,0,52,1,52,1,malware,trickbot
-4472564355450563761,10.127.0.30,34.117.59.81,443,tcp,tls,227,438,10,631,10,1069,20,malware,trickbot
7131262223809602794,10.127.0.30,104.26.4.15,443,tcp,http,238,44214,38,1568,24,45782,62,malware,trickbot
5780166763667492878,10.127.0.30,172.67.75.166,443,tcp,http,233,4730,8,886,7,5616,15,malware,trickbot
5066398332777735164,10.127.0.30,104.17.215.67,80,tcp,http,276,774,4,460,4,1234,8,malware,trickbot
935347610065716187,10.127.0.30,104.17.215.67,443,tcp,tls,115,438,10,637,10,1075,20,malware,trickbot
9059841876466887465,10.127.0.33,8.8.8.8,53,udp,dns,204,854,7,427,7,1281,14,normal,-
-2061852520443041702,10.127.0.80,120.79.51.185,53,udp,dns,0,0,0,400,5,400,5,normal,-
-1296342377609295685,10.127.0.114,40.126.31.71,443,tcp,-,15057,0,0,260,5,260,5,malware,trickbot
-8807577559714902846,10.127.0.114,31.31.196.244,80,tcp,http,29749,2283430,1646,50819,925,2334249,2571,malware,trickbot
3965856903436319623,10.127.0.114,224.0.0.251,5353,udp,-,0,0,0,158,2,158,2,malware,trickbot
8619719420516472962,10.127.0.114,208.67.104.60,80,tcp,-,3017,0,0,156,3,156,3,malware,trickbot
2720442086715017633,10.127.0.114,34.117.59.81,443,tcp,http,25866,6629,10,969,10,7598,20,malware,trickbot
6291856958439103541,10.127.0.114,87.240.129.133,80,tcp,-,15025,0,0,260,5,260,5,normal,-
3738147079750340970,10.127.0.114,93.186.225.194,80,tcp,tls,472,1198,12,1034,16,2232,28,normal,-
-2632987108033603220,10.127.0.114,93.186.225.194,443,tcp,http,2250,323411,236,11581,238,334992,474,normal,-
5673981567809482015,10.127.0.25,35.188.105.97,9919,tcp,-,6803,344,8,1964,10,2308,18,malware,trickbot
8571105372501838129,10.127.0.25,35.188.105.97,9920,tcp,-,3369,172,4,1110,5,1282,9,malware,trickbot
8177396152226467056,10.127.0.183,190.152.4.210,449,tcp,-,9998,600,15,780,15,1380,30,malware,trickbot
-1283694474232277920,10.127.0.183,131.255.82.24,449,tcp,-,0,0,0,52,1,52,1,malware,trickbot
8467459293980626131,10.127.0.180,93.184.221.240,80,tcp,-,18943,0,0,322,7,322,7,malware,trickbot
5719830537025004169,10.127.0.180,52.152.110.14,443,tcp,-,45116,0,0,780,15,780,15,malware,trickbot
-1726376333904854736,10.127.0.180,204.79.197.203,80,tcp,-,18953,0,0,322,7,322,7,malware,trickbot
-691794955993238060,10.127.0.70,95.101.74.152,443,tcp,http,60372,5390,13,1071,12,6461,25,malware,trickbot
-5670501487479212847,10.127.0.70,23.72.252.168,443,tcp,http,60168,143017,110,3166,59,146183,169,normal,-
-15192712632631974,10.127.0.190,193.56.146.220,4174,tcp,-,39280,64850,1223,4434873,3270,4499723,4493,malware,amadey
1121292289276406009,10.127.0.190,31.41.244.200,80,tcp,http,110341,734,8,953,10,1687,18,malware,amadey
-8997578087904875426,10.127.0.165,193.56.146.220,4174,tcp,-,25914,64313,1295,5252472,3873,5316785,5168,malware,amadey
-8398984434105601814,10.127.0.165,31.41.244.200,80,tcp,http,219953,814,10,1046,12,1860,22,malware,amadey
6925115603749306642,10.127.0.215,193.56.146.11,4173,tcp,-,50895,0,0,760,15,760,15,malware,amadey
7307935409933583631,10.127.0.120,193.56.146.220,4174,tcp,-,12105,24001,440,1747836,1290,1771837,1730,malware,amadey
-1713359952863009050,10.127.0.120,31.41.244.200,80,tcp,-,20317,0,0,304,6,304,6,malware,amadey
-8067863295723280648,10.127.0.142,193.56.146.218,80,tcp,http,114411,95210,77,2466,45,97676,122,malware,amadey
2855568491577229868,10.127.0.183,193.56.146.220,4174,tcp,-,24576,44127,745,2940370,2199,2984497,2944,malware,amadey
9184737343184326182,10.127.0.183,31.41.244.200,80,tcp,http,220009,814,10,1046,12,1860,22,malware,amadey
7588312415789090520,10.127.0.93,193.56.146.220,4174,tcp,-,11617,25432,447,1691573,1248,1717005,1695,malware,amadey
-2275802774092910953,10.127.0.93,31.41.244.200,80,tcp,http,65150,602,5,482,5,1084,10,malware,amadey
-929198401879586395,10.127.0.27,193.56.146.220,4174,tcp,-,15065,41897,762,3017381,2203,3059278,2965,malware,amadey
-2488878665992755698,10.127.0.27,31.41.244.200,80,tcp,http,65124,602,5,482,5,1084,10,malware,amadey
8846042772328729673,10.127.0.114,193.56.146.11,4173,tcp,-,50898,0,0,760,15,760,15,malware,amadey
3576244658978720233,10.127.0.29,193.56.146.220,4174,tcp,-,11166,27456,522,1966447,1450,1993903,1972,malware,amadey
4174838312777993845,10.127.0.29,31.41.244.200,80,tcp,http,65120,602,5,482,5,1084,10,malware,amadey
7803774153623718972,10.127.0.92,193.233.20.28,4125,tcp,-,13448,42970,848,2453223,1785,2496193,2633,malware,amadey
-7192189486179686979,10.127.0.92,31.41.244.200,80,tcp,http,65185,602,5,482,5,1084,10,malware,amadey
-6128513040382876408,10.127.0.54,193.233.20.28,4125,tcp,-,10166,36599,730,2112911,1512,2149510,2242,malware,amadey
-103872878515721275,10.127.0.54,31.41.244.200,80,tcp,http,220005,814,10,1046,12,1860,22,malware,amadey
-2857462856707882642,10.127.0.115,193.56.146.220,4174,tcp,-,46334,97219,1812,6826174,4867,6923393,6679,malware,amadey
5630582422744285440,10.127.0.164,23.254.227.214,80,tcp,http,5105,483,5,485,6,968,11,malware,amadey
-1184607220825829510,10.127.0.164,23.254.227.202,80,tcp,http,8522,3552,28,6146,39,9698,67,malware,amadey
8124430731497329360,10.127.0.164,23.254.227.205,80,tcp,http,5098,483,5,485,6,968,11,malware,amadey
7936625467546873481,10.127.0.164,208.67.104.60,80,tcp,-,3009,0,0,156,3,156,3,malware,amadey
-2925267984909916318,10.127.0.164,224.0.0.251,5353,udp,-,0,0,0,158,2,158,2,malware,amadey
-6250323068026993567,10.127.0.164,34.117.59.81,443,tcp,-,15051,0,0,260,5,260,5,malware,amadey
-2001828421819658987,10.127.0.164,104.26.5.15,443,tcp,http,4957,43930,39,1624,25,45554,64,malware,amadey
-6933702987471460757,10.127.0.164,104.26.4.15,443,tcp,http,4401,4376,8,947,8,5323,16,malware,amadey
-2335760665293755644,10.127.0.164,104.17.214.67,80,tcp,http,4194,433,3,500,5,933,8,malware,amadey
-3819139482355285924,10.127.0.164,104.17.214.67,443,tcp,http,4090,5123,10,976,9,6099,19,malware,amadey
1210405622485135932,10.127.0.164,87.240.129.133,80,tcp,tls,560,1198,12,1034,16,2232,28,normal,-
4968204015493382572,10.127.0.164,87.240.129.133,443,tcp,http,1815,323395,236,11581,238,334976,474,normal,-
649165582922790871,10.127.0.188,52.109.8.44,443,tcp,-,0,40,1,0,0,40,1,malware,amadey
2546111949346876644,10.127.0.139,31.41.244.200,80,tcp,http,114370,642,6,528,6,1170,12,malware,amadey
6343562756319861938,10.127.0.54,193.56.146.220,4174,tcp,-,10172,29650,554,2123975,1450,2153625,2004,malware,amadey
-8119098731622180518,10.127.0.8,104.21.8.227,443,tcp,http,2330,664584,576,14520,302,679104,878,malware,amadey
6878065771969485285,10.127.0.8,34.142.181.181,53,udp,-,20344,781744,1403,72860,1391,854604,2794,malware,amadey
-8077450149234127930,10.127.0.8,208.95.112.1,80,tcp,http,93112,951,6,1269,9,2220,15,malware,amadey
-2957472804134986606,10.127.0.8,172.67.168.62,443,tcp,http,239888,12466,31,4066,28,16532,59,malware,amadey
-3670387560366013911,10.127.0.105,193.56.146.220,4174,tcp,-,10772,19778,340,1140135,859,1159913,1199,malware,amadey
2658781291241082403,10.127.0.105,31.41.244.200,80,tcp,http,109998,407,5,523,6,930,11,malware,amadey
-1803909292109094733,10.127.0.172,193.56.146.220,4174,tcp,-,27835,12030,108,433183,333,445213,441,malware,amadey
-1205315638309821121,10.127.0.172,31.41.244.200,80,tcp,http,395,562,4,436,4,998,8,malware,amadey
-5349321071927178384,10.127.0.30,193.56.146.11,4173,tcp,-,50062,0,0,760,15,760,15,malware,amadey
-3063865743918252478,10.127.0.178,13.69.109.130,443,tcp,-,18952,0,0,322,7,322,7,malware,amadey
-1330678476526790727,10.127.0.178,193.56.146.220,4174,tcp,-,22082,7542,35,69479,81,77021,116,malware,amadey
-5725905041402552371,10.127.0.178,52.152.110.14,443,tcp,-,45019,0,0,780,15,780,15,malware,amadey
-3379756728378005812,10.127.0.178,31.41.244.200,80,tcp,http,65092,367,4,477,5,844,9,malware,amadey
-4932661306623709586,10.127.0.108,193.56.146.11,4173,tcp,-,78176,0,0,1456,28,1456,28,malware,amadey
-137503592412938104,10.127.0.110,52.109.77.0,443,tcp,-,0,40,1,0,0,40,1,malware,amadey
-5958049964904236557,10.127.0.57,193.56.146.220,4174,tcp,-,11120,26484,515,2123809,1449,2150293,1964,malware,amadey
3238006469485758412,10.127.0.57,20.189.173.14,443,tcp,-,18951,0,0,322,7,322,7,malware,amadey
2180792439095128089,10.127.0.57,31.41.244.200,80,tcp,http,110004,407,5,523,6,930,11,malware,amadey
392301880753874763,10.127.0.57,8.247.211.254,80,tcp,-,37906,0,0,644,14,644,14,malware,amadey
1608011535782695822,10.127.0.108,193.56.146.218,80,tcp,http,115132,94935,75,3887,76,98822,151,malware,amadey
9141845582166085761,10.127.0.115,31.41.244.200,80,tcp,http,175092,1009,10,1005,11,2014,21,malware,amadey
-6500066906703006979,10.127.0.122,31.41.244.200,80,tcp,http,224533,1049,11,1051,12,2100,23,malware,amadey
-5998885892842285843,10.127.0.77,193.56.146.220,4174,tcp,-,13332,48728,931,3571242,2614,3619970,3545,malware,amadey
6000422546031682560,10.127.0.77,31.41.244.200,80,tcp,http,65151,602,5,482,5,1084,10,malware,amadey
-3147918545634499847,10.127.0.65,193.56.146.220,4174,tcp,-,12833,34738,714,2312436,1709,2347174,2423,malware,amadey
8851389893239468556,10.127.0.65,31.41.244.200,80,tcp,-,15020,0,0,260,5,260,5,malware,amadey
-1696572605009326374,10.127.0.20,193.56.146.220,4174,tcp,-,24374,78186,1490,5334184,3915,5412370,5405,malware,amadey
-8144008239844909587,10.127.0.20,31.41.244.200,80,tcp,http,130243,1204,10,964,10,2168,20,malware,amadey
2847466845487492687,10.127.0.188,52.109.13.63,443,tcp,-,0,40,1,0,0,40,1,malware,amadey
5491581165044170628,10.127.0.188,193.56.146.11,4173,tcp,-,75121,0,0,1352,26,1352,26,malware,amadey
2605869680342474354,10.127.0.188,87.248.205.0,80,tcp,-,0,40,1,46,1,86,2,malware,amadey
-8296939928878890355,10.127.0.2,31.41.244.200,80,tcp,http,65643,602,5,768,6,1370,11,malware,amadey
-2534591764755044695,10.127.0.19,193.56.146.220,4174,tcp,-,24088,52350,1120,4040339,2957,4092689,4077,malware,amadey
-1094201853705489916,10.127.0.19,193.56.146.218,80,tcp,http,43942,95130,75,2374,43,97504,118,malware,amadey
-8281032697298753126,10.127.0.214,193.56.146.220,4174,tcp,-,12171,28950,522,1909231,1300,1938181,1822,malware,amadey
2875455914489806485,10.127.0.214,31.41.244.200,80,tcp,http,65092,602,5,482,5,1084,10,malware,amadey
4531856918182371443,10.127.0.177,40.126.32.68,443,tcp,-,15002,0,0,260,5,260,5,malware,amadey
-5035643742220704454,10.127.0.177,193.56.146.218,80,tcp,http,115081,94935,75,3887,76,98822,151,malware,amadey
2520178425382835098,10.127.0.124,20.224.254.73,443,tcp,-,0,40,1,0,0,40,1,malware,amadey
-7513829031153004909,10.127.0.124,209.197.3.8,80,tcp,-,8016,0,0,104,2,104,2,malware,amadey
-3018891096077148182,10.127.0.124,31.41.244.200,80,tcp,http,110012,407,5,523,6,930,11,malware,amadey
-4785350096391791825,10.127.0.121,31.41.244.200,80,tcp,http,109973,407,5,523,6,930,11,malware,amadey
4047034152183401803,10.127.0.98,193.56.146.220,4174,tcp,-,37153,33763,537,1985308,1503,2019071,2040,malware,amadey
-3243221309737590202,10.127.0.98,31.41.244.200,80,tcp,http,175141,774,9,1000,11,1774,20,malware,amadey
-4360291211066377399,10.127.0.68,193.56.146.220,4174,tcp,-,11927,21480,336,1304000,969,1325480,1305,malware,amadey
4222337672761172744,10.127.0.68,31.41.244.200,80,tcp,http,65148,602,5,482,5,1084,10,malware,amadey
3936008784058972068,10.127.0.184,31.41.244.200,80,tcp,http,110059,407,5,523,6,930,11,malware,amadey
-7979856104977725611,10.127.0.146,193.56.146.220,4174,tcp,-,13541,47317,950,3818943,2583,3866260,3533,malware,amadey
8417809716880610920,10.127.0.146,31.41.244.200,80,tcp,http,65089,602,5,482,5,1084,10,malware,amadey
261212927194065642,10.127.0.101,23.254.227.214,80,tcp,http,5105,794,6,491,6,1285,12,malware,amadey
4920550246388124712,10.127.0.101,23.254.227.202,80,tcp,http,5103,794,6,491,6,1285,12,malware,amadey
7721450258186191128,10.127.0.101,23.254.227.205,80,tcp,http,5101,794,6,537,7,1331,13,malware,amadey
-5720415229775758036,10.127.0.101,208.67.104.60,80,tcp,-,0,0,0,52,1,52,1,malware,amadey
6827051510132338251,10.127.0.101,34.117.59.81,443,tcp,tls,300,438,10,631,10,1069,20,malware,amadey
-7371197917369878785,10.127.0.101,104.26.5.15,443,tcp,http,989,50221,50,2466,31,52687,81,malware,amadey
8167754184904566706,10.127.0.101,104.17.214.67,80,tcp,http,310,774,4,506,5,1280,9,malware,amadey
-361653920791820399,10.127.0.101,104.17.214.67,443,tcp,tls,253,478,11,683,11,1161,22,malware,amadey
1699315115734709516,10.127.0.189,45.136.113.107,80,tcp,http,110023,1575135,1453,51761,1123,1626896,2576,malware,amadey
8679483559719987624,10.127.0.189,104.21.8.227,443,tcp,-,15019,0,0,260,5,260,5,malware,amadey
-2929800952111194991,10.127.0.189,77.73.134.27,80,tcp,http,254512,1280101,2845,437090,8492,1717191,11337,malware,amadey
-2298325706396191774,10.127.0.189,45.9.74.80,80,tcp,http,144203,52175292,37270,1740101,37273,53915393,74543,malware,amadey
-4821595878518531118,10.127.0.189,157.240.221.35,443,tcp,http,110000,151104,119,6909,66,158013,185,normal,-
5025101392667069495,10.127.0.189,45.66.159.179,80,tcp,http,67872,1538,10,2202,12,3740,22,malware,amadey
-8436408009718675584,10.127.0.189,172.67.158.22,443,tcp,http,2184,662908,534,13231,274,676139,808,malware,amadey
-5556568381172036722,10.127.0.211,193.56.146.220,4174,tcp,-,16826,32009,583,2387138,1622,2419147,2205,malware,amadey
-7531834455333772578,10.127.0.211,31.41.244.200,80,tcp,http,65097,602,5,482,5,1084,10,malware,amadey
-1623728807246676822,10.127.0.116,193.56.146.220,4174,tcp,-,11675,20238,315,1499742,1025,1519980,1340,malware,amadey
7801719903666282113,10.127.0.116,31.41.244.200,80,tcp,http,65088,602,5,482,5,1084,10,malware,amadey
8907710831306996787,10.127.0.109,40.126.32.76,443,tcp,-,45034,0,0,780,15,780,15,malware,amadey
-8250915563373820617,10.127.0.109,193.56.146.220,4174,tcp,-,10827,7863,43,70762,80,78625,123,malware,amadey
7334070722544056189,10.127.0.109,31.41.244.200,80,tcp,http,109992,407,5,523,6,930,11,malware,amadey
-2928401017320989609,10.127.0.192,193.56.146.220,4174,tcp,-,11603,24942,470,1955415,1448,1980357,1918,malware,amadey
1608268753034427791,10.127.0.192,193.56.146.218,80,tcp,http,115155,94935,75,3887,76,98822,151,malware,amadey
9125057880261536362,10.127.0.76,193.56.146.220,4174,tcp,-,23573,20780,327,1762869,1287,1783649,1614,malware,amadey
-5137414692604833239,10.127.0.76,31.41.244.200,80,tcp,http,65153,602,5,482,5,1084,10,malware,amadey
5263824931701493648,10.127.0.179,193.56.146.220,4174,tcp,-,36487,35781,685,2967813,2147,3003594,2832,malware,amadey
4559317491987134128,10.127.0.179,193.56.146.218,80,tcp,http,19792,95130,75,2374,43,97504,118,malware,amadey
-629412563405587954,10.127.0.103,193.56.146.220,4174,tcp,-,10423,12701,164,586219,452,598920,616,malware,amadey
-30818909606314342,10.127.0.103,31.41.244.200,80,tcp,http,109974,407,5,523,6,930,11,malware,amadey
-864263310687257489,10.127.0.80,193.56.146.220,4174,tcp,-,27319,22617,377,1210731,916,1233348,1293,malware,amadey
-7311698945522840702,10.127.0.80,31.41.244.200,80,tcp,http,65124,367,4,477,5,844,9,malware,amadey
-2599451288313404103,10.127.0.159,193.56.146.11,4173,tcp,-,75193,0,0,1300,25,1300,25,malware,amadey
-7082008434692296967,10.127.0.99,31.41.244.200,80,tcp,http,65146,602,5,482,5,1084,10,malware,amadey
