Flow id,Src IP,Dst IP,Dst port,Protocol,Application protocol,Duration,Received bytes,Received packets,Transmitted bytes,Transmitted packets,Total bytes,Total packets,label,family
101839207200919836,10.0.2.15,45.57.91.1,443,tcp,-,63099,467165,356,19332,270,486497,626,normal,-
-39236173195564561,10.0.2.15,142.251.37.110,443,tcp,tls,1873298,1084184,1429,132509,1180,1216693,2609,normal,-
8241443478711596101,10.0.2.15,185.199.109.154,443,tcp,-,192005,451943,412,23276,294,475219,706,normal,-
-5046472066674943199,10.0.2.15,142.251.36.106,443,tcp,tls,377244,264248,822,117934,774,382182,1596,normal,-
5347319502865209866,10.0.2.15,146.75.120.193,443,tcp,tls,175272,561462,461,20010,261,581472,722,normal,-
-3656488926098362647,10.0.2.15,151.101.193.69,443,tcp,tls,230019,617106,541,32210,404,649316,945,normal,-
-2095579213857418410,10.0.2.15,142.251.37.104,443,tcp,tls,226627,395910,348,16319,178,412229,526,normal,-
-8441567842405116804,10.0.2.15,140.82.112.25,443,tcp,tls,8366,9048,32,5974,30,15022,62,normal,-
-8215221357526815521,10.0.2.15,192.0.73.2,443,tcp,tls,63965,89673,143,14999,120,104672,263,normal,-
4046711451672289662,10.0.2.15,104.17.32.82,443,tcp,-,163,180,3,384,6,564,9,normal,-
-7249589588360022667,10.0.2.15,142.251.36.98,443,tcp,tls,1851310,605737,925,92163,763,697900,1688,normal,-
-1420045016947431704,10.0.2.15,147.229.9.26,443,tcp,tls,216861,620923,528,33186,317,654109,845,normal,-
-6506847499386655766,10.0.2.15,67.27.213.122,443,tcp,-,745,960,16,2048,32,3008,48,normal,-
-8955940420221196972,10.0.2.15,151.101.194.206,443,tcp,-,173688,689616,519,27699,451,717315,970,normal,-
-6550140355802229482,10.0.2.15,147.229.9.226,443,tcp,-,207738,330780,576,86949,540,417729,1116,normal,-
-4897978596436559358,10.0.2.15,192.229.221.95,80,tcp,-,5926393,194128,1008,134008,1046,328136,2054,normal,-
5082298001779832860,10.0.2.15,13.32.110.82,443,tcp,-,106526,680,10,786,10,1466,20,normal,-
-133440136347563932,10.0.2.15,209.140.136.194,443,tcp,tls,129935,24084,54,9606,55,33690,109,normal,-
8778341475023808891,10.0.2.15,142.251.36.65,443,tcp,tls,357365,810865,802,54738,570,865603,1372,normal,-
5246432985792630942,10.0.2.15,151.101.129.69,443,tcp,tls,584,13340,30,3114,26,16454,56,normal,-
6241443927401530724,10.0.2.15,151.101.193.69,80,tcp,-,67442,720,12,648,12,1368,24,normal,-
9167017816801255710,10.0.2.15,157.240.30.174,443,tcp,tls,1284,156348,130,5884,64,162232,194,normal,-
-644741052351960842,10.0.2.15,142.251.37.97,443,tcp,tls,179683,711475,696,47021,491,758496,1187,normal,-
6501705892624929267,10.0.2.15,216.239.34.36,443,tcp,tls,568581,111255,299,36996,286,148251,585,normal,-
277061941061847704,10.0.2.15,34.117.237.239,443,tcp,-,1400790,43833,170,16908,165,60741,335,normal,-
111159312016706072,10.0.2.15,95.100.146.41,80,tcp,-,2159345,71428,352,44397,369,115825,721,normal,-
7168746081179387887,fe80:0000:0000:0000:8fc8:b416:45a8:93c4,ff02:0000:0000:0000:0000:0000:0000:00fb,5353,udp,-,79373,0,0,6920,49,6920,49,normal,-
7156139017526962566,10.0.2.15,224.0.0.251,5353,udp,-,77181,0,0,4095,41,4095,41,normal,-
-3868496579351225335,10.0.2.15,104.18.6.29,443,tcp,tls,446,12198,24,2920,24,15118,48,normal,-
-4450004502894781830,10.0.2.15,142.251.36.132,443,tcp,tls,2735843,950187,1337,123628,1013,1073815,2350,normal,-
4584758697424882077,10.0.2.15,104.244.42.2,443,tcp,-,348086,54461,130,56505,121,110966,251,normal,-
5674076555105974085,10.0.2.15,146.75.116.159,443,tcp,tls,176051,255110,269,17622,173,272732,442,normal,-
-7515630690946124152,10.0.2.15,34.107.221.82,80,tcp,-,2086361,19594,268,19070,273,38664,541,normal,-
2792490901068046551,10.0.2.15,142.251.36.110,443,tcp,tls,1115122,146033,318,37881,314,183914,632,normal,-
398335552255754485,10.0.2.15,151.101.193.140,443,tcp,tls,2404073,9208100,7020,320421,3490,9528521,10510,normal,-
8605097794893808263,10.0.2.15,35.244.174.68,443,tcp,tls,2332,33080,78,9710,76,42790,154,normal,-
-7198978090318656091,10.0.2.15,142.251.36.67,443,tcp,tls,1307214,983933,1143,90037,855,1073970,1998,normal,-
-3897493395602619949,10.0.2.15,142.251.36.129,443,tcp,tls,14553,321837,482,48555,423,370392,905,normal,-
-7059663803976873444,10.0.2.15,185.199.111.133,443,tcp,tls,187092,142851,240,24435,232,167286,472,normal,-
-5230576495706771882,10.0.2.15,152.199.21.141,443,tcp,-,204994,4623246,3743,133794,1319,4757040,5062,normal,-
9130813297027771567,10.0.2.15,104.19.188.97,443,tcp,tls,1733865,1515910,1308,75571,970,1591481,2278,normal,-
1077570314360189165,10.0.2.15,172.67.71.230,443,tcp,tls,322,12814,24,2920,24,15734,48,normal,-
6369495502481478227,10.0.2.15,142.251.37.99,80,tcp,-,962410,27029,160,19722,165,46751,325,normal,-
-6325797372210314142,10.0.2.15,157.240.30.27,443,tcp,tls,521656,1231462,1177,69361,785,1300823,1962,normal,-
-8818860313818083153,10.0.2.15,142.251.36.138,443,tcp,-,805443,1366304,1424,107679,943,1473983,2367,normal,-
-4157417754129473824,10.0.2.15,142.251.36.78,443,tcp,tls,23688,1223433,1070,58069,656,1281502,1726,normal,-
4917640744839152322,10.0.2.15,142.251.36.99,443,tcp,tls,1392670,1892194,1768,109140,1174,2001334,2942,normal,-
7898957554304280946,10.0.2.15,31.30.189.206,443,tcp,tls,231148,14114,46,4704,48,18818,94,normal,-
-1884143775377259848,10.0.2.15,104.18.7.29,443,tcp,tls,172229,478636,398,19743,237,498379,635,normal,-
4684745851057711076,10.0.2.15,91.189.91.49,80,tcp,http,2986,882,10,754,10,1636,20,normal,-
-4347074525453619545,10.0.2.15,142.251.36.67,80,tcp,-,1301450,27412,189,20623,196,48035,385,normal,-
4673750635884781660,10.0.2.15,142.251.36.142,443,tcp,tls,1776421,818917,1008,89984,808,908901,1816,normal,-
-7926794734002783272,10.0.2.15,142.251.37.99,443,tcp,tls,911946,91329,180,18563,165,109892,345,normal,-
7461065320117331418,10.0.2.15,8.8.8.8,53,udp,dns,14479694,1076301,6387,585062,6404,1661363,12791,normal,-
-4699328576966186604,10.0.2.15,172.64.155.188,80,tcp,http,1681644,48297,260,29569,275,77866,535,normal,-
1621100242814921079,10.0.2.15,142.251.37.110,443,udp,-,439497,6414934,6139,955115,3138,7370049,9277,normal,-
-7178471050195100847,10.0.2.15,142.251.36.130,443,tcp,tls,2948863,495767,1012,112352,949,608119,1961,normal,-
-7021734148527112348,10.0.2.15,146.75.122.167,443,tcp,tls,1025517,390167,551,128839,436,519006,987,normal,-
5546437883735843597,10.0.2.15,31.30.189.77,443,tcp,tls,347018,290920,257,14771,158,305691,415,normal,-
1623241788894168592,10.0.2.15,157.240.30.63,443,tcp,tls,176541,1337098,1013,30581,391,1367679,1404,normal,-
-785856817720453198,10.0.2.15,13.32.110.8,443,tcp,tls,530908,182496,203,15195,142,197691,345,normal,-
5391284539523287831,10.0.2.15,52.223.202.71,443,tcp,tls,6220,4063898,2963,124852,1804,4188750,4767,normal,-
-6266458317992297632,10.0.2.15,142.251.37.99,443,udp,-,78989,1002374,884,105152,427,1107526,1311,normal,-
-6502477056673014330,10.0.2.15,18.192.246.211,443,tcp,tls,192992,32916,109,31968,119,64884,228,normal,-
4712013047323652461,10.0.2.15,52.28.203.152,443,tcp,tls,304373,81306,238,51003,228,132309,466,normal,-
1082555921555438021,10.0.2.15,50.17.196.195,443,tcp,tls,174603,21461,52,6457,51,27918,103,normal,-
702939889214431033,10.0.2.15,142.251.37.98,443,tcp,tls,1825846,482335,691,65479,587,547814,1278,normal,-
-4705660322526577466,10.0.2.15,104.18.43.158,443,tcp,tls,1885109,87319,348,102729,340,190048,688,normal,-
-4827206761167884568,10.0.2.15,216.24.57.3,443,tcp,tls,1384,14358,36,4216,36,18574,72,normal,-
-5538641674308170451,10.0.2.15,142.251.36.67,443,udp,-,196013,1104340,1107,151626,624,1255966,1731,normal,-
4654648830300002485,10.0.2.15,18.66.15.86,443,tcp,-,503,14250,31,3446,33,17696,64,normal,-
-4705026434631418573,10.0.2.15,142.251.37.118,443,tcp,tls,515863,50000,115,13315,119,63315,234,normal,-
7977083941887609789,10.0.2.15,13.32.110.91,443,tcp,tls,359169,546765,447,38062,413,584827,860,normal,-
-6011026534715628840,10.0.2.15,140.82.121.5,443,tcp,tls,292032,54882,303,247506,304,302388,607,normal,-
5782573007158225747,10.0.2.15,54.213.102.132,443,tcp,tls,57862,18894,54,6942,56,25836,110,normal,-
3879350755946399163,54.186.10.12,10.0.2.15,33688,tcp,-,0,375,5,435,6,810,11,normal,-
3029291998828298786,10.0.2.15,18.66.25.126,443,tcp,tls,199349,1841836,1448,60610,768,1902446,2216,normal,-
2260075765788031269,10.0.2.15,142.251.36.68,443,tcp,-,731961,953589,1077,98985,757,1052574,1834,normal,-
-1532502455921988262,10.0.2.15,35.202.21.90,443,tcp,tls,188562,57824,75,7764,77,65588,152,normal,-
-3022922382308990498,10.0.2.15,157.240.30.35,443,tcp,tls,178868,135809,338,40298,304,176107,642,normal,-
-6987456855265834837,10.0.2.15,35.158.206.94,443,tcp,tls,18677,50521,138,34977,140,85498,278,normal,-
-2310414284867681427,10.0.2.15,140.82.114.22,443,tcp,tls,277078,17690,74,14866,74,32556,148,normal,-
-3497835195380015359,10.0.2.15,18.66.15.56,443,tcp,tls,340,13972,26,3028,26,17000,52,normal,-
-4026523145268538765,10.0.2.15,35.244.181.201,443,tcp,-,567905,12840,56,5495,54,18335,110,normal,-
-7122823603959540231,10.0.2.15,35.71.161.21,443,tcp,tls,16772,18740,49,12987,55,31727,104,normal,-
-5589253172349537027,10.0.2.15,142.251.36.98,443,udp,-,344323,1467118,1614,235333,867,1702451,2481,normal,-
2363276305224916673,10.0.2.15,142.251.37.98,443,udp,-,21132,774415,726,80126,336,854541,1062,normal,-
1604348892301649448,10.0.2.15,142.251.36.104,443,tcp,tls,172654,342146,294,13227,143,355373,437,normal,-
8349214499150425110,10.0.2.15,172.64.153.246,443,tcp,tls,938,261280,206,8022,102,269302,308,normal,-
3056069551630976412,10.0.2.15,142.251.37.109,443,tcp,tls,346151,671312,613,37060,406,708372,1019,normal,-
1875868952529585513,10.0.2.15,185.172.151.128,443,tcp,tls,10714,15259,34,4101,34,19360,68,normal,-
-617088490895525849,10.0.2.15,35.192.151.63,443,tcp,tls,6706,12396,18,2154,20,14550,38,normal,-
3031840993186645859,10.0.2.15,142.251.36.86,443,tcp,tls,347356,51737,77,7061,65,58798,142,normal,-
-2789668086884296190,10.0.2.15,142.251.36.132,443,udp,-,408148,5030544,5641,675216,2460,5705760,8101,normal,-
7686723360529113302,10.0.2.15,13.32.2.178,443,tcp,tls,1640578,6506189,4833,221486,2931,6727675,7764,normal,-
4963788708435714809,10.0.2.15,209.140.129.85,443,tcp,tls,348958,31268,80,9841,81,41109,161,normal,-
4220260151203682139,10.0.2.15,142.251.36.118,443,tcp,tls,513218,37217,91,9991,93,47208,184,normal,-
2182193346986053587,10.0.2.15,209.140.129.56,443,tcp,tls,233574,41332,70,15224,72,56556,142,normal,-
-5200032102577731234,10.0.2.15,52.29.27.99,443,tcp,tls,12224,25460,70,50884,74,76344,144,normal,-
-4880568270726088667,10.0.2.15,147.229.2.90,80,tcp,http,15859,2576,13,1682,14,4258,27,normal,-
6577977160849637962,10.0.2.15,142.251.36.99,443,udp,-,286961,5895945,4880,451720,1633,6347665,6513,normal,-
-6145251373832961682,10.0.2.15,18.66.23.210,443,tcp,tls,172751,55171,114,16700,110,71871,224,normal,-
5755502723997349957,10.0.2.15,52.58.226.158,443,tcp,tls,177862,22045,75,19124,77,41169,152,normal,-
5209082428709486779,10.0.2.15,18.158.95.160,443,tcp,tls,522,8890,28,3288,28,12178,56,normal,-
-895802344472891605,10.0.2.15,192.124.249.23,80,tcp,http,199386,8986,36,3250,36,12236,72,normal,-
6528246052011854551,10.0.2.15,104.18.6.185,443,tcp,tls,570,19810,38,4246,32,24056,70,normal,-
6069196734611446662,10.0.2.15,23.195.249.37,443,tcp,tls,124107,110587,125,12017,95,122604,220,normal,-
3920412181798516909,10.0.2.15,142.251.36.68,443,udp,-,190905,2883082,3246,397333,1423,3280415,4669,normal,-
8788584656776091990,10.0.2.15,34.98.64.218,443,tcp,tls,180867,23190,75,13755,73,36945,148,normal,-
4583703505446640761,10.0.2.15,54.93.71.13,443,tcp,tls,62358,10974,40,4822,38,15796,78,normal,-
4039561924141082165,10.0.2.15,140.82.121.3,443,tcp,tls,404006,801075,654,50556,549,851631,1203,normal,-
-7609397628138803473,10.0.2.15,104.18.25.185,443,tcp,tls,9035,20406,68,23485,71,43891,139,normal,-
1015595363658524798,10.0.2.15,142.251.37.97,443,udp,-,42182,457638,444,44261,209,501899,653,normal,-
-1596943230074075686,10.0.2.15,209.140.136.167,443,tcp,tls,240236,22488,74,29344,74,51832,148,normal,-
-7158523897807597513,10.0.2.15,142.251.36.138,443,udp,-,23394,733456,652,57847,291,791303,943,normal,-
-7845565370449270467,10.0.2.15,13.32.110.7,443,tcp,-,2120,120,2,256,4,376,6,normal,-
-1487222592399251030,10.0.2.15,13.32.110.29,443,tcp,tls,60085,69715,136,16366,149,86081,285,normal,-
8162042308635414907,10.0.2.15,216.239.34.36,443,udp,-,92421,393100,624,178646,637,571746,1261,normal,-
3070456849929619179,10.0.2.15,13.32.110.109,443,tcp,tls,348609,81491,113,9027,87,90518,200,normal,-
-4956486917687811798,10.0.2.15,185.64.189.112,443,tcp,-,422467,34157,111,27493,115,61650,226,normal,-
-3609665569947989560,10.0.2.15,18.66.15.18,443,tcp,tls,4574,87354,84,6228,70,93582,154,normal,-
-3386135650664457559,10.0.2.15,142.251.36.106,443,udp,-,71159,273154,322,62161,209,335315,531,normal,-
-129918218650914539,10.0.2.15,18.66.15.27,443,tcp,-,172979,8951,23,2877,25,11828,48,normal,-
-6889652008505716421,10.0.2.15,147.229.2.90,443,tcp,tls,9393,1158300,859,29797,387,1188097,1246,normal,-
-972996754376411135,10.0.2.15,54.71.68.203,443,tcp,tls,58154,38254,232,36144,224,74398,456,normal,-
-7802358195241365321,10.0.2.15,104.18.22.52,443,tcp,tls,343132,57895,97,9148,78,67043,175,normal,-
8677389662140624974,10.0.2.15,142.251.36.74,443,udp,-,40136,148570,169,25325,114,173895,283,normal,-
-435242797846932770,10.0.2.15,142.251.37.104,443,udp,-,2048,321160,250,15376,66,336536,316,normal,-
7839696812174532764,10.0.2.15,35.188.42.15,443,tcp,tls,384424,33598,110,14318,106,47916,216,normal,-
-2237156979592134309,10.0.2.15,142.251.36.129,443,udp,-,10361,331222,334,49344,221,380566,555,normal,-
-8008066182675257085,10.0.2.15,142.251.36.65,443,udp,-,30276,1872247,1428,64604,260,1936851,1688,normal,-
-3265560433588044055,10.0.2.15,67.27.213.250,443,tcp,tls,341768,520232,394,13498,196,533730,590,normal,-
-6153954895354577239,10.0.2.15,13.32.6.222,80,tcp,-,1489380,41128,231,26004,250,67132,481,normal,-
8911118451101882039,10.0.2.15,52.46.143.56,443,tcp,tls,261488,20910,60,8432,58,29342,118,normal,-
8531450612327087994,10.0.2.15,52.223.202.37,443,tcp,tls,1118,167198,128,9144,94,176342,222,normal,-
-6825809100625048535,10.0.2.15,162.19.138.116,443,tcp,tls,14028,12156,30,3790,30,15946,60,normal,-
4692177409197131499,10.0.2.15,142.251.36.86,443,udp,-,17472,753662,589,24078,176,777740,765,normal,-
391820322496247538,10.0.2.15,142.250.102.156,443,tcp,tls,1396,20251,58,6929,53,27180,111,normal,-
4452827317078532191,10.0.2.15,142.251.36.110,443,udp,-,65162,3274000,2763,497220,1175,3771220,3938,normal,-
-2232485488103517094,10.0.2.15,34.107.203.240,443,tcp,tls,1060,44504,56,4736,44,49240,100,normal,-
-6198757746816452740,10.0.2.15,178.250.0.165,443,tcp,tls,32001,19697,93,26454,91,46151,184,normal,-
-7620475165389890931,10.0.2.15,142.251.36.66,443,tcp,tls,811677,276353,380,32318,301,308671,681,normal,-
4828598591773819964,10.0.2.15,34.111.208.231,443,tcp,tls,171617,19840,49,6015,50,25855,99,normal,-
4168088970857737896,10.0.2.15,141.95.98.65,443,tcp,tls,14710,13812,30,6166,32,19978,62,normal,-
-4909113079268380555,10.0.2.15,104.18.20.226,80,tcp,http,1572389,78166,282,31119,293,109285,575,normal,-
-7006264477151733164,10.0.2.15,104.17.33.82,443,udp,-,3862,326322,308,22934,94,349256,402,normal,-
5627098464801876381,10.0.2.15,151.101.193.26,443,tcp,tls,744,13894,36,4172,34,18066,70,normal,-
8992025232349473913,10.0.2.15,13.32.11.208,80,tcp,http,263518,6048,38,3932,40,9980,78,normal,-
-4316063030227343405,10.0.2.15,104.244.42.65,443,tcp,tls,514847,122638,145,18297,130,140935,275,normal,-
-8012683039361383853,10.0.2.15,52.223.198.20,443,tcp,tls,21956,251185,235,38999,218,290184,453,normal,-
8133856524195069883,10.0.2.15,209.140.129.67,443,tcp,tls,233152,18588,56,12870,56,31458,112,normal,-
5853329624523241619,10.0.2.15,193.48.96.10,443,tcp,tls,20032,4544379,3135,57149,994,4601528,4129,normal,-
843516873232454711,10.0.2.15,23.195.249.65,443,tcp,tls,368637,38032,117,25974,118,64006,235,normal,-
-2511616512224606482,10.0.2.15,213.19.162.51,443,tcp,tls,41174,23341,77,17769,80,41110,157,normal,-
-4665460956199828502,10.0.2.15,157.240.30.27,443,udp,-,57889,1967017,1719,81132,562,2048149,2281,normal,-
-6333578569210897719,10.0.2.15,23.195.249.137,443,tcp,tls,243880,35262,82,13412,78,48674,160,normal,-
-5391024805869189848,10.0.2.15,142.251.36.70,443,tcp,tls,342111,26025,68,8110,71,34135,139,normal,-
2286984870832733836,10.0.2.15,209.140.129.84,443,tcp,tls,234126,28796,62,9194,58,37990,120,normal,-
3283578204904654232,10.0.2.15,157.240.30.63,443,udp,-,5508,716754,622,21664,148,738418,770,normal,-
-8459373648016347550,10.0.2.15,209.140.129.90,443,tcp,tls,234266,19092,58,11264,58,30356,116,normal,-
-173331421579581748,10.0.2.15,54.155.178.5,443,tcp,tls,360914,86804,134,35324,124,122128,258,normal,-
1633742229455547603,10.0.2.15,104.16.87.20,443,tcp,tls,30539,142887,218,21156,173,164043,391,normal,-
5707885257789880324,10.0.2.15,104.26.4.62,443,tcp,tls,341680,51914,82,7072,60,58986,142,normal,-
1862279717068928623,10.0.2.15,52.214.191.127,443,tcp,tls,125208,18058,44,6426,44,24484,88,normal,-
-5906655447090201062,10.0.2.15,35.83.96.182,443,tcp,tls,124446,10270,36,4172,36,14442,72,normal,-
-8284631211646401676,10.0.2.15,104.16.56.101,443,tcp,tls,571010,45122,87,9142,78,54264,165,normal,-
-3017313138097058704,10.0.2.15,13.32.14.22,443,tcp,tls,145208,1622571,1212,51216,728,1673787,1940,normal,-
-8887450103394785030,10.0.2.15,31.30.189.206,443,udp,-,1122,625306,468,15946,104,641252,572,normal,-
1930620599039348293,10.0.2.15,209.140.141.61,443,tcp,tls,233394,22324,58,8250,58,30574,116,normal,-
6334087051895267300,10.0.2.15,142.251.36.142,443,udp,-,184376,4910692,4456,974377,2258,5885069,6714,normal,-
-3644127337136163313,10.0.2.15,142.250.102.155,443,tcp,tls,614,13364,36,4562,34,17926,70,normal,-
7286245261436444746,10.0.2.15,128.84.21.199,443,tcp,tls,84838,1114821,862,49483,653,1164304,1515,normal,-
-6864746092691730030,10.0.2.15,13.32.110.126,443,tcp,tls,341394,72342,88,6148,66,78490,154,normal,-
-1165233802820755036,10.0.2.15,104.16.168.82,443,tcp,tls,172548,17051,48,5807,48,22858,96,normal,-
4716405967641462052,10.0.2.15,142.251.37.109,443,udp,-,23087,680411,645,70598,279,751009,924,normal,-
-2497081338118988184,10.0.2.15,142.251.36.78,443,udp,-,264219,351998,456,111494,364,463492,820,normal,-
8548507353459014083,10.0.2.15,18.66.15.22,443,tcp,tls,469430,63444,148,21766,144,85210,292,normal,-
-8514937186410464045,10.0.2.15,35.156.198.41,443,tcp,tls,181414,26071,71,13989,76,40060,147,normal,-
-5675002551521691264,10.0.2.15,18.66.22.211,443,tcp,tls,2619,222967,201,13487,167,236454,368,normal,-
-3730688389858704208,10.0.2.15,142.251.36.70,443,udp,-,1360,38186,46,11143,45,49329,91,normal,-
-334089610546589278,10.0.2.15,185.89.210.101,443,tcp,tls,22574,11298,28,4454,26,15752,54,normal,-
216891057290230664,10.0.2.15,104.18.3.119,443,tcp,tls,3818,238952,186,9908,138,248860,324,normal,-
-1362585966298504858,10.0.2.15,157.240.30.35,443,udp,-,355450,136453,450,245989,383,382442,833,normal,-
3491303129958400602,10.0.2.15,18.66.15.52,443,tcp,tls,172126,22313,48,5566,48,27879,96,normal,-
7943224992181027560,10.0.2.15,18.66.15.30,443,tcp,tls,234810,231952,208,28708,176,260660,384,normal,-
7674314626526274886,10.0.2.15,18.66.15.74,443,tcp,tls,189872,88906,99,9013,100,97919,199,normal,-
8999313386019188073,10.0.2.15,18.66.15.64,443,tcp,tls,282257,48098,103,13815,101,61913,204,normal,-
-2978656728378674371,10.0.2.15,18.66.17.190,443,tcp,tls,147046,974265,758,30328,400,1004593,1158,normal,-
-7619389840897810266,10.0.2.15,157.240.30.174,443,udp,-,14410,1390786,1442,109412,402,1500198,1844,normal,-
-7986173057305473322,10.0.2.15,2.16.2.186,443,tcp,tls,206157,592617,623,41387,422,634004,1045,normal,-
2219154358669246626,10.0.2.15,216.239.32.36,443,tcp,tls,293738,87216,246,33553,234,120769,480,normal,-
715011796239902602,10.0.2.15,18.66.23.213,443,tcp,tls,983185,244075,263,17915,185,261990,448,normal,-
4479334461905406148,10.0.2.15,18.66.15.83,443,tcp,tls,342040,16662,42,4704,42,21366,84,normal,-
5880596567214167779,10.0.2.15,142.251.36.118,443,udp,-,12622,1958702,1499,40337,283,1999039,1782,normal,-
-7994315786461460687,10.0.2.15,142.250.27.155,443,tcp,tls,3104,26697,75,9373,75,36070,150,normal,-
-8242139646359779220,10.0.2.15,162.247.243.29,443,tcp,tls,467403,28918,116,21314,116,50232,232,normal,-
1470591158166537388,10.0.2.15,23.73.140.46,443,tcp,tls,617577,1549057,1316,69915,880,1618972,2196,normal,-
9006843329491898097,10.0.2.15,104.18.13.159,443,tcp,tls,342096,12698,38,4348,36,17046,74,normal,-
1124286117462592270,10.0.2.15,52.94.223.37,443,tcp,tls,510264,55934,143,25017,137,80951,280,normal,-
-3892487973076927180,10.0.2.15,77.75.76.182,443,tcp,tls,80308,337739,329,18483,212,356222,541,normal,-
-6522709196874475436,10.0.2.15,77.75.78.30,443,tcp,tls,260470,600751,575,55328,472,656079,1047,normal,-
4947313481933489197,10.0.2.15,77.75.77.16,443,tcp,tls,53713,1353993,1109,55081,747,1409074,1856,normal,-
6521180118225458823,10.0.2.15,104.64.124.188,443,tcp,tls,234598,25790,60,5670,52,31460,112,normal,-
-4255802467974678770,10.0.2.15,23.185.0.4,443,tcp,tls,380490,2602184,1860,50934,776,2653118,2636,normal,-
-5983168624583970322,10.0.2.15,13.32.110.93,443,tcp,tls,814831,464618,480,37571,327,502189,807,normal,-
698028667489397207,10.0.2.15,51.11.20.152,443,tcp,tls,150650,30644,54,5106,54,35750,108,normal,-
2271102247321102839,10.0.2.15,13.107.42.14,443,tcp,tls,1138675,238662,521,65194,486,303856,1007,normal,-
2471546282542931712,10.0.2.15,104.22.52.86,443,tcp,tls,341406,45764,62,4906,46,50670,108,normal,-
-1998402031482382585,10.0.2.15,13.32.110.48,443,tcp,tls,342172,58502,70,5218,52,63720,122,normal,-
-2175489054317038966,10.0.2.15,104.26.1.148,443,tcp,tls,365730,2810978,2126,166432,1218,2977410,3344,normal,-
-3501740982082561214,10.0.2.15,77.75.78.126,443,tcp,tls,44838,126562,112,5976,68,132538,180,normal,-
-6053579743876340312,10.0.2.15,13.32.110.81,443,tcp,tls,469573,112612,165,15136,143,127748,308,normal,-
6652106319690936821,10.0.2.15,77.75.78.104,443,tcp,tls,214204,598928,696,83162,533,682090,1229,normal,-
-181221413529819519,10.0.2.15,13.32.110.123,443,tcp,tls,341930,15980,44,4776,42,20756,86,normal,-
-3821888396766463008,10.0.2.15,151.101.194.167,443,tcp,tls,231648,20332,54,5628,52,25960,106,normal,-
5123933208896259302,10.0.2.15,52.10.130.119,443,tcp,tls,401134,55748,622,687996,624,743744,1246,normal,-
-1627156167571176382,10.0.2.15,13.32.110.89,443,tcp,tls,342122,149914,140,7102,76,157016,216,normal,-
-231827515301636629,10.0.2.15,13.32.110.51,443,tcp,tls,344670,17134,46,7522,48,24656,94,normal,-
6309197441479402800,10.0.2.15,77.75.79.165,443,tcp,tls,133853,20622,58,6965,58,27587,116,normal,-
-8685330227426076243,10.0.2.15,18.66.15.47,443,tcp,tls,342106,34376,58,5166,50,39542,108,normal,-
-7328368147571681551,10.0.2.15,69.16.175.42,443,tcp,tls,684308,190983,195,12535,143,203518,338,normal,-
-5167446606686926194,10.0.2.15,20.186.185.227,443,tcp,tls,344674,11622,42,5102,42,16724,84,normal,-
-1155858879251443039,10.0.2.15,34.242.66.151,443,tcp,tls,351268,40476,108,18186,110,58662,218,normal,-
-5926562939092744317,10.0.2.15,13.32.110.85,443,tcp,tls,346718,17500,52,12452,54,29952,106,normal,-
2994106456760412495,10.0.2.15,77.75.77.234,443,tcp,tls,54106,78728,80,5354,58,84082,138,normal,-
-6226168502055124576,10.0.2.15,77.75.76.30,443,tcp,tls,566883,892649,889,94218,685,986867,1574,normal,-
-7806125030011536396,10.0.2.15,141.95.47.55,443,tcp,tls,153124,83437,128,13041,121,96478,249,normal,-
1334874477173825019,10.0.2.15,18.66.17.28,443,tcp,tls,341756,232774,190,8038,104,240812,294,normal,-
-8790965653068586582,10.0.2.15,192.28.144.124,443,tcp,tls,151458,11698,38,4880,36,16578,74,normal,-
-6458709852762151890,10.0.2.15,13.32.110.34,443,tcp,tls,374422,32058,54,8898,48,40956,102,normal,-
4792455940947567721,10.0.2.15,77.75.78.101,443,tcp,tls,53826,83782,86,4868,48,88650,134,normal,-
-5097436474113742087,10.0.2.15,77.75.79.232,443,tcp,tls,34316,13920,38,5250,38,19170,76,normal,-
254949970124367151,10.0.2.15,18.66.15.53,443,tcp,tls,341562,84898,96,5962,60,90860,156,normal,-
4141705984090764270,10.0.2.15,2.18.36.230,443,tcp,tls,241478,150174,148,7868,90,158042,238,normal,-
7093477611222289225,10.0.2.15,23.195.248.219,443,tcp,tls,501517,8053923,5669,94075,1385,8147998,7054,normal,-
2257021863313542230,10.0.2.15,13.32.110.120,443,tcp,tls,591882,857778,734,55774,640,913552,1374,normal,-
-6885530249407872893,10.0.2.15,104.22.71.197,443,tcp,tls,172179,44173,66,6190,50,50363,116,normal,-
-1411844276552217913,10.0.2.15,13.32.110.39,443,tcp,tls,343730,1116660,844,32876,484,1149536,1328,normal,-
4399265468233202918,10.0.2.15,44.195.173.150,443,tcp,tls,283168,41988,240,93750,240,135738,480,normal,-
8837464367515429336,10.0.2.15,13.37.25.97,443,tcp,tls,228090,50554,154,33422,152,83976,306,normal,-
-997184236737357915,10.0.2.15,18.66.15.62,443,tcp,tls,342392,29464,52,4786,44,34250,96,normal,-
8091885286112171710,10.0.2.15,34.249.131.158,443,tcp,tls,374924,13712,52,6386,50,20098,102,normal,-
413702221869564722,10.0.2.15,13.32.110.18,443,tcp,tls,277346,22052,54,6168,50,28220,104,normal,-
-2736634270685504658,10.0.2.15,104.17.71.206,443,tcp,tls,344882,181166,164,9832,98,190998,262,normal,-
6240021558969669209,10.0.2.15,142.251.36.100,443,tcp,tls,1270331,914291,989,78808,693,993099,1682,normal,-
9160415513874528510,10.0.2.15,77.75.78.124,443,tcp,tls,19637,2259023,1652,43354,616,2302377,2268,normal,-
5412056814946881161,10.0.2.15,151.101.194.137,443,tcp,tls,465296,95951,165,16183,137,112134,302,normal,-
-8713856128192658366,10.0.2.15,77.75.79.222,443,tcp,tls,154484,146406,167,13369,121,159775,288,normal,-
3866731466339477169,10.0.2.15,52.94.238.249,443,tcp,tls,276518,39728,210,208954,212,248682,422,normal,-
8515728268171316011,10.0.2.15,18.66.16.191,443,tcp,tls,419567,69603,97,8077,75,77680,172,normal,-
1661238387744180856,10.0.2.15,18.66.15.36,443,tcp,tls,497750,127405,146,10195,111,137600,257,normal,-
-7647524560762836824,10.0.2.15,13.32.11.185,443,tcp,tls,341412,76516,82,5558,58,82074,140,normal,-
-9088288867684652465,10.0.2.15,77.75.76.104,443,tcp,tls,285819,118926,171,16223,161,135149,332,normal,-
-6236603686882649602,10.0.2.15,77.75.79.69,443,tcp,tls,309820,72827,111,11098,102,83925,213,normal,-
6115542316158383515,10.0.2.15,13.32.11.64,443,tcp,tls,284348,477818,364,20726,328,498544,692,normal,-
-8523013892802624279,10.0.2.15,77.75.77.195,443,tcp,tls,1475139,3150582,2692,137617,1724,3288199,4416,normal,-
3264685308312135088,10.0.2.15,142.251.36.104,443,udp,-,2187,729986,546,21248,151,751234,697,normal,-
7900357974980154849,10.0.2.15,142.251.36.100,443,udp,-,415142,2643929,3288,577707,1729,3221636,5017,normal,-
-2925489117811435877,10.0.2.15,17.253.144.10,80,tcp,http,6048,2066,13,1498,14,3564,27,normal,-
-1132616130516186628,10.0.2.15,91.189.91.48,80,tcp,http,712,882,10,754,10,1636,20,normal,-
-5518134634184615207,10.0.2.15,142.251.36.130,443,udp,-,414311,1869017,2185,388227,1341,2257244,3526,normal,-
-572149072093031454,10.0.2.15,34.107.203.240,443,udp,-,446,12022,14,3808,12,15830,26,normal,-
3879490774679732266,10.0.2.15,216.239.32.36,443,udp,-,537284,97262,638,133602,424,230864,1062,normal,-
-5960138749379405291,10.0.2.15,142.251.36.66,443,udp,-,103225,889594,846,96234,397,985828,1243,normal,-
-4014666135511205624,10.0.2.15,18.66.22.211,443,udp,-,44216,1897082,1349,46463,300,1943545,1649,normal,-
-6333979370450975047,10.0.2.15,142.250.27.155,443,udp,-,1021,14500,23,7290,17,21790,40,normal,-
495102613189730604,10.0.2.15,104.16.168.82,443,udp,-,32844,20981,39,7727,27,28708,66,normal,-
4606324131903724555,10.0.2.15,104.18.32.68,80,tcp,http,1445464,36419,219,23393,232,59812,451,normal,-
7121905652316629313,10.0.2.15,185.125.190.56,123,udp,ntp,1644,1620,18,1620,18,3240,36,normal,-
8165186143306450306,10.0.2.15,54.186.10.12,443,tcp,-,458,1060,16,780,12,1840,28,normal,-
6956397219713116951,10.0.2.15,77.75.77.16,80,tcp,http,63712,1856,17,1818,20,3674,37,normal,-
6488935007784305604,10.0.2.15,34.111.208.231,443,udp,-,332,12034,14,3806,12,15840,26,normal,-
7287434880812362021,10.0.2.15,151.101.193.26,443,udp,-,5280,9420,14,4616,14,14036,28,normal,-
-4038835775564272738,10.0.2.15,172.64.153.246,443,udp,-,438,14646,22,3854,12,18500,34,normal,-
2651610283054211978,10.0.2.15,17.253.73.201,80,tcp,http,171704,5828,28,2542,30,8370,58,normal,-
1877227473300716304,10.0.2.15,104.18.3.119,443,udp,-,26848,7480698,6290,326748,1606,7807446,7896,normal,-
7206774299746329237,10.0.2.15,31.30.189.77,443,udp,-,6284,4346764,3168,57742,426,4404506,3594,normal,-
-5225193833397387253,10.0.2.15,104.22.71.197,443,udp,-,1434,17518,36,7342,26,24860,62,normal,-
-5949061212128317833,10.0.2.15,104.18.25.185,443,udp,-,3117,18862,51,27669,63,46531,114,normal,-
7503051371436127846,10.0.2.15,34.120.208.123,443,tcp,-,3237576,166219,1038,377488,931,543707,1969,normal,-
8188582468022340191,10.0.2.15,104.18.6.185,443,udp,-,6518,264998,268,97622,156,362620,424,normal,-
-3166870345157398928,10.0.2.15,216.24.57.3,443,udp,-,896,18742,32,5324,22,24066,54,normal,-
-1949329153937503920,10.0.2.15,18.66.15.18,443,udp,-,1746,28576,32,5214,22,33790,54,normal,-
-8181309862805257713,10.0.2.15,35.244.174.68,443,udp,-,805,32598,31,7783,26,40381,57,normal,-
2052156738506733178,10.0.2.15,142.250.102.156,443,udp,-,1065,25920,33,7806,22,33726,55,normal,-
-1983790921125677673,10.0.2.15,142.250.102.155,443,udp,-,350,4524,8,3258,6,7782,14,normal,-
3294078645466033243,10.0.2.15,104.16.87.20,443,udp,-,5370,243040,260,23101,86,266141,346,normal,-
-3044690018620932933,10.0.2.15,142.251.37.118,443,udp,-,29876,189609,178,16021,88,205630,266,normal,-
8813273736401528751,10.0.2.15,142.251.36.72,443,tcp,tls,353638,1862706,1549,71808,866,1934514,2415,normal,-
-6333531391643063944,137.254.60.32,10.0.2.15,39252,tcp,-,4110,6768,66,160898,128,167666,194,normal,-
-5612634909974258706,10.0.2.15,137.254.60.32,443,tcp,tls,11750,131388,106,5282,56,136670,162,normal,-
4198043621590285737,10.0.2.15,188.114.96.3,443,tcp,tls,12876,1987584,1584,77243,1038,2064827,2622,normal,-
6926724482618780076,10.0.2.15,142.251.36.99,80,tcp,-,4398483,125366,716,91090,739,216456,1455,normal,-
1963805744411951937,10.0.2.15,13.32.110.11,443,tcp,-,375993,20610,59,5974,59,26584,118,normal,-
-3827389805705621578,10.0.2.15,185.125.190.18,80,tcp,http,2515,2205,25,1885,25,4090,50,normal,-
-7973133921297537225,10.0.2.15,142.251.36.72,443,udp,-,105602,2507850,1978,98899,673,2606749,2651,normal,-
640315809994342448,10.0.2.15,35.241.9.150,443,tcp,-,547125,91375,118,6346,80,97721,198,normal,-
5324463435300704068,10.0.2.15,146.75.122.251,443,tcp,tls,177169,2023731,1475,44770,669,2068501,2144,normal,-
6832038688223347956,10.0.2.15,35.186.224.25,443,tcp,tls,176226,39399,97,12306,93,51705,190,normal,-
4336897410290097201,10.0.2.15,34.98.74.57,443,tcp,tls,7136,17159,48,5704,47,22863,95,normal,-
2413301968574419458,10.0.2.15,35.186.224.17,443,tcp,tls,4097,27521,81,14625,77,42146,158,normal,-
5858380037600771377,10.0.2.15,188.114.96.3,443,udp,-,30797,10965166,9134,188460,970,11153626,10104,normal,-
-2867262859771606087,10.0.2.15,34.160.144.191,443,tcp,-,954644,45945,132,11891,120,57836,252,normal,-
3433592798472181979,10.0.2.15,151.101.65.69,443,tcp,tls,176173,492384,457,25178,281,517562,738,normal,-
-3806389028060501,10.0.2.15,142.251.36.131,443,tcp,tls,695522,392221,493,43936,423,436157,916,normal,-
-1537549717776993351,10.0.2.15,146.75.116.193,443,tcp,tls,171209,27425,58,5739,49,33164,107,normal,-
8779718915762256255,10.0.2.15,146.75.118.248,443,tcp,tls,818391,691014,639,33933,379,724947,1018,normal,-
-3203052804674428759,10.0.2.15,188.114.97.3,443,tcp,tls,8574,11040923,7749,169725,2675,11210648,10424,normal,-
354890794243622684,10.0.2.15,198.252.206.25,443,tcp,tls,727357,18917,47,5072,40,23989,87,normal,-
-3152638526230255568,10.0.2.15,146.75.122.248,443,tcp,tls,581743,482734,434,18617,234,501351,668,normal,-
1656530026982425139,10.0.2.15,142.251.36.131,443,udp,-,185631,692668,807,142301,496,834969,1303,normal,-
3469493778948296575,44.226.72.95,10.0.2.15,41144,tcp,-,8,553,7,725,10,1278,17,normal,-
4073638384584905098,10.0.2.15,35.186.224.17,443,udp,-,3053,19487,58,67273,85,86760,143,normal,-
5388318294450070316,10.0.2.15,185.125.190.48,80,tcp,http,362,1323,15,1185,16,2508,31,normal,-
5997233826300582841,10.0.2.15,34.98.74.57,443,udp,-,599,13935,18,5448,15,19383,33,normal,-
-1542716388663943119,10.0.2.15,188.114.97.3,443,udp,-,6749,1404340,1205,85571,419,1489911,1624,normal,-
5129000875774407706,10.0.2.15,172.64.144.98,443,tcp,tls,660880,34311,123,22978,119,57289,242,normal,-
7236228578957487967,10.0.2.15,104.26.12.155,443,tcp,tls,343138,14699,48,5876,48,20575,96,normal,-
8492375104233833596,10.0.2.15,35.186.224.25,443,udp,-,5522,69064,76,14113,50,83177,126,normal,-
7514462253742464840,10.0.2.15,34.107.204.85,443,tcp,tls,293045,109783,204,23816,189,133599,393,normal,-
-1705805674077404664,10.0.2.15,104.17.25.14,443,tcp,tls,2862,87790,104,8036,68,95826,172,normal,-
-400499726325353039,10.0.2.15,142.251.37.100,443,tcp,tls,1590,37450,62,6478,55,43928,117,normal,-
-2225454695631401435,10.0.2.15,13.32.110.105,443,tcp,tls,72928,134750,133,11196,87,145946,220,normal,-
6984799851311189708,10.0.2.15,146.75.122.251,443,udp,-,40352,4855176,3866,134076,824,4989252,4690,normal,-
5840785190210741368,10.0.2.15,52.17.243.237,443,tcp,-,60874,9329,23,2552,24,11881,47,normal,-
2370734922073424764,10.0.2.15,18.66.15.113,443,tcp,tls,172359,149704,142,8872,95,158576,237,normal,-
-4381735984989735849,10.0.2.15,151.101.192.95,443,tcp,tls,8263,349938,417,34954,313,384892,730,normal,-
6501428588567974237,10.0.2.15,37.252.171.22,443,tcp,tls,40278,19529,49,7555,48,27084,97,normal,-
1271133779480369259,10.0.2.15,2.16.2.105,443,tcp,tls,40396,17000,36,3962,30,20962,66,normal,-
3337148249682760613,10.0.2.15,54.229.62.148,443,tcp,tls,181459,22206,63,6865,63,29071,126,normal,-
-3266680155500934126,10.0.2.15,104.16.86.20,443,tcp,tls,171199,58870,76,6286,50,65156,126,normal,-
-5763306942758242087,10.0.2.15,142.251.36.80,443,tcp,tls,1705,89699,140,13821,111,103520,251,normal,-
2495090758176115927,10.0.2.15,162.159.130.22,443,tcp,tls,376102,586969,473,21008,264,607977,737,normal,-
6212443368644791300,10.0.2.15,46.4.70.163,443,tcp,tls,5627,21146,77,13666,70,34812,147,normal,-
8596616301275820435,10.0.2.15,104.26.9.237,443,tcp,tls,1130,10358,30,4030,30,14388,60,normal,-
7017053246130139334,10.0.2.15,142.251.36.74,443,tcp,tls,126528,87501,215,28497,194,115998,409,normal,-
590156010487404051,10.0.2.15,15.236.125.10,443,tcp,tls,162584,14666,58,24154,58,38820,116,normal,-
-223933949262135881,10.0.2.15,52.6.97.148,80,tcp,http,195806,8694,36,3264,36,11958,72,normal,-
2438885917628124680,10.0.2.15,35.241.9.51,443,tcp,tls,13845,31955,85,10753,83,42708,168,normal,-
-265774863973052950,10.0.2.15,54.171.39.218,443,tcp,tls,127072,23346,58,11608,60,34954,118,normal,-
-7285907535205074660,10.0.2.15,104.45.152.60,443,tcp,tls,249863,20744,66,7411,70,28155,136,normal,-
4478447715965818744,10.0.2.15,162.247.241.2,443,tcp,tls,672184,36686,150,46036,152,82722,302,normal,-
-8833781820908621785,10.0.2.15,104.18.232.170,443,tcp,tls,340948,9824,36,4920,36,14744,72,normal,-
-6372248474425741930,10.0.2.15,185.86.138.154,443,tcp,tls,33157,18607,45,10093,45,28700,90,normal,-
85419105854628833,10.0.2.15,52.45.65.87,443,tcp,tls,175318,20537,45,5647,46,26184,91,normal,-
-5427837288208995771,10.0.2.15,37.252.171.52,443,tcp,tls,31608,17311,46,12022,42,29333,88,normal,-
-5287204440751545661,10.0.2.15,185.235.84.0,443,tcp,tls,20542,9886,32,3896,30,13782,62,normal,-
79084578757109676,10.0.2.15,178.250.0.157,443,tcp,tls,130260,92134,214,27640,198,119774,412,normal,-
-6486640556494803984,10.0.2.15,18.66.15.55,443,tcp,tls,866,14058,28,3136,28,17194,56,normal,-
-6222924589383900955,10.0.2.15,104.16.57.101,443,tcp,tls,884165,56019,181,52488,177,108507,358,normal,-
-4553388617148926509,10.0.2.15,54.157.58.70,443,tcp,tls,122984,12366,36,4244,36,16610,72,normal,-
-1109872593142732040,10.0.2.15,3.123.113.122,443,tcp,tls,171919,20746,56,7566,58,28312,114,normal,-
5800728904106845778,10.0.2.15,8.8.8.8,53,tcp,dns,8363,5183,25,1786,25,6969,50,normal,-
4702102960432080050,10.0.2.15,23.44.215.58,443,tcp,tls,42094,49322,58,4474,40,53796,98,normal,-
8061942030485566714,10.0.2.15,178.250.1.9,443,tcp,tls,20462,11622,34,4834,32,16456,66,normal,-
6444065346212638742,10.0.2.15,52.205.116.41,443,tcp,tls,173590,71729,89,7532,67,79261,156,normal,-
-6393469288494445496,10.0.2.15,74.119.119.150,443,tcp,tls,21020,17638,38,5050,36,22688,74,normal,-
7000895717259522847,10.0.2.15,104.17.24.14,443,tcp,tls,757,29382,57,6010,49,35392,106,normal,-
-273716277733011668,10.0.2.15,185.80.39.216,443,tcp,tls,8746,43137,81,16189,84,59326,165,normal,-
6592085062648688485,10.0.2.15,104.17.208.240,443,tcp,tls,202980,51927,78,8058,73,59985,151,normal,-
-9083294852703718784,10.0.2.15,178.250.1.11,443,tcp,tls,41315,31244,75,9118,71,40362,146,normal,-
-3170726391631329276,10.0.2.15,178.250.0.130,443,tcp,tls,53017,151972,166,12059,119,164031,285,normal,-
167672894034449418,10.0.2.15,104.70.106.152,443,tcp,tls,712964,4981530,3670,169492,1784,5151022,5454,normal,-
3482325226071723159,10.0.2.15,146.75.116.157,443,tcp,-,675443,90369,142,12351,119,102720,261,normal,-
-3213480816201584360,10.0.2.15,104.16.122.175,443,tcp,tls,341326,35924,52,4616,40,40540,92,normal,-
-1157729861199048850,10.0.2.15,104.244.42.133,443,tcp,tls,368006,26279,107,17756,106,44035,213,normal,-
5391275160337748996,10.0.2.15,3.229.52.136,443,tcp,tls,209889,22478,61,7450,62,29928,123,normal,-
8440800058311895707,10.0.2.15,95.100.146.27,80,tcp,http,273380,5556,40,4028,42,9584,82,normal,-
1664556309664383586,10.0.2.15,40.71.11.145,443,tcp,tls,347650,39481,83,7244,73,46725,156,normal,-
-811843118995749874,10.0.2.15,34.248.102.220,443,tcp,tls,135260,26863,68,7806,68,34669,136,normal,-
-782292841467148754,10.0.2.15,142.250.102.157,443,tcp,tls,1070,13350,36,4536,34,17886,70,normal,-
7445531326517627624,10.0.2.15,104.96.131.246,80,tcp,http,322319,12913,53,5273,57,18186,110,normal,-
-5003592044052910892,10.0.2.15,70.42.32.95,443,tcp,tls,15866,8862,26,3694,26,12556,52,normal,-
4399749488789134320,10.0.2.15,34.107.254.252,443,tcp,tls,1014414,78051,222,31683,221,109734,443,normal,-
-5525861238573972626,10.0.2.15,104.18.233.170,443,tcp,tls,341358,9840,36,5858,36,15698,72,normal,-
2142180958561362588,10.0.2.15,23.195.248.244,443,tcp,tls,538339,412444,383,19435,209,431879,592,normal,-
-1838961469000952675,10.0.2.15,104.244.42.131,443,tcp,tls,944175,48507,187,30236,185,78743,372,normal,-
6686740969899580549,10.0.2.15,23.64.54.221,443,tcp,tls,816928,65808,193,18369,174,84177,367,normal,-
2421518076880737882,10.0.2.15,37.157.3.20,443,tcp,tls,241856,12594,44,5078,44,17672,88,normal,-
-7329387567504046034,10.0.2.15,185.64.190.80,443,tcp,-,178381,6544,23,2730,24,9274,47,normal,-
-7232849749405812397,10.0.2.15,13.32.110.10,443,tcp,tls,342746,101676,100,5548,58,107224,158,normal,-
6693344933705757855,10.0.2.15,178.250.0.163,443,tcp,tls,32209,21118,61,7706,57,28824,118,normal,-
-4072319491109703497,10.0.2.15,52.212.210.65,443,tcp,tls,125126,20792,54,9796,54,30588,108,normal,-
8136062387387027497,10.0.2.15,13.32.110.40,443,tcp,tls,389642,296380,234,8934,114,305314,348,normal,-
6675291520612554358,10.0.2.15,172.67.73.228,443,tcp,tls,342738,3912362,2722,42764,708,3955126,3430,normal,-
688602062283906285,10.0.2.15,104.17.33.105,443,tcp,tls,318,12754,24,2920,24,15674,48,normal,-
-1271544777790737472,10.0.2.15,52.73.70.139,443,tcp,tls,387452,16036,46,6296,44,22332,90,normal,-
-8523160738428884024,10.0.2.15,104.19.150.54,443,tcp,tls,403968,265055,225,13974,187,279029,412,normal,-
4809299719353993840,10.0.2.15,34.111.234.236,443,tcp,tls,2982,53904,75,7536,76,61440,151,normal,-
-4368149603234263777,10.0.2.15,69.173.144.138,443,tcp,tls,233442,10264,46,4794,44,15058,90,normal,-
5409776679570504899,10.0.2.15,13.248.245.213,443,tcp,tls,514260,22227,64,8316,63,30543,127,normal,-
-2677066267564268435,10.0.2.15,104.244.42.69,443,tcp,tls,465497,15563,68,9227,68,24790,136,normal,-
-2721399568979250209,10.0.2.15,151.101.192.95,443,udp,-,25732,522800,463,64979,230,587779,693,normal,-
-4826304140484318344,10.0.2.15,18.66.15.55,443,udp,-,483,23387,25,6432,21,29819,46,normal,-
-4102970526747756447,10.0.2.15,142.251.36.80,443,udp,-,45068,55085,72,13304,58,68389,130,normal,-
6060085904799619960,10.0.2.15,34.107.254.252,443,udp,-,17502,65581,115,58588,124,124169,239,normal,-
-6909514035208499840,10.0.2.15,34.122.121.32,80,tcp,-,64574,120,2,848,12,968,14,normal,-
851153935097669812,10.0.2.15,162.159.133.86,443,tcp,tls,399654,21462,74,15330,72,36792,146,normal,-
-1187940715640100882,10.0.2.15,141.226.228.48,443,tcp,tls,124454,17203,53,6944,50,24147,103,normal,-
1666598753629974375,10.0.2.15,185.235.84.162,443,tcp,tls,20658,10000,34,4114,34,14114,68,normal,-
7647970724618804175,10.0.2.15,52.51.0.212,443,tcp,tls,342090,13004,44,4920,42,17924,86,normal,-
3253785920051940038,10.0.2.15,162.159.136.70,443,tcp,tls,392900,246476,276,25296,250,271772,526,normal,-
-1686118487127919725,10.0.2.15,13.32.110.90,443,tcp,tls,171358,113882,117,8273,83,122155,200,normal,-
-3504923550184275343,10.0.2.15,185.255.84.153,443,tcp,tls,42006,16270,40,4550,40,20820,80,normal,-
1259836689685132601,10.0.2.15,142.251.37.100,443,udp,-,51337,24971,44,9352,32,34323,76,normal,-
-8526444576202342817,10.0.2.15,23.195.248.24,443,tcp,tls,619073,439831,422,27496,276,467327,698,normal,-
-806247302599878127,10.0.2.15,151.101.194.217,443,tcp,tls,637137,511894,454,22692,271,534586,725,normal,-
9174798669752950480,10.0.2.15,34.107.204.85,443,udp,-,397849,126341,395,119933,417,246274,812,normal,-
-4295582889276717190,10.0.2.15,52.6.87.177,443,tcp,tls,342792,14748,42,4938,40,19686,82,normal,-
-4484964322571194823,10.0.2.15,13.32.11.228,443,tcp,tls,341230,69280,80,5760,60,75040,140,normal,-
-1492997923836421588,10.0.2.15,13.107.21.200,443,tcp,tls,1709681,285487,552,68836,488,354323,1040,normal,-
-8251302580015394998,10.0.2.15,34.117.157.22,443,tcp,tls,2490,13588,40,4450,38,18038,78,normal,-
-4681724486517781918,10.0.2.15,162.159.130.86,443,tcp,tls,340706,44788,62,5108,48,49896,110,normal,-
1444433007230970741,10.0.2.15,18.185.222.214,443,tcp,tls,342836,15900,42,5008,42,20908,84,normal,-
7111363664430354511,10.0.2.15,52.59.122.232,443,tcp,tls,30036,14634,40,4948,40,19582,80,normal,-
-6964013315827763246,10.0.2.15,77.75.79.195,443,tcp,tls,585037,294092,356,30515,299,324607,655,normal,-
-8054345582956171549,10.0.2.15,104.18.7.57,443,tcp,tls,384,12778,24,2920,24,15698,48,normal,-
-1072049018846717305,10.0.2.15,3.67.240.173,443,tcp,tls,61478,13986,40,4834,42,18820,82,normal,-
-3934203326992474167,10.0.2.15,151.101.193.108,443,tcp,tls,116589,78969,90,6702,61,85671,151,normal,-
8526627039230112096,10.0.2.15,13.32.110.74,443,tcp,tls,512838,142728,171,12987,121,155715,292,normal,-
2156082482313967016,10.0.2.15,13.32.11.16,443,tcp,tls,232280,20494,52,5012,52,25506,104,normal,-
3573131863774350094,10.0.2.15,35.244.159.8,443,tcp,tls,4126,34786,82,19387,80,54173,162,normal,-
-8189791356423245541,10.0.2.15,104.26.9.237,443,udp,-,302,12916,20,3656,10,16572,30,normal,-
4130111790566673731,10.0.2.15,178.250.1.25,443,tcp,tls,20526,10494,34,4322,32,14816,66,normal,-
1683666373790156086,10.0.2.15,52.29.202.243,443,tcp,tls,342744,15696,48,5590,48,21286,96,normal,-
-3295671181563145949,10.0.2.15,67.220.228.200,443,tcp,tls,139594,19154,40,7758,36,26912,76,normal,-
499256039394930365,10.0.2.15,91.228.74.166,443,tcp,tls,248497,62498,114,15979,101,78477,215,normal,-
4099222333638610320,10.0.2.15,35.241.9.51,443,udp,-,629,19953,23,7370,21,27323,44,normal,-
-876532221388378273,10.0.2.15,52.209.66.62,443,tcp,tls,344446,14336,46,5090,44,19426,90,normal,-
-45469258066919024,10.0.2.15,104.17.25.14,443,udp,-,1032,100178,97,7165,29,107343,126,normal,-
-5003393025333326083,10.0.2.15,104.18.12.210,443,tcp,tls,447528,310502,296,20766,258,331268,554,normal,-
3475680237876686833,10.0.2.15,104.18.6.57,443,tcp,tls,171842,78278,102,8852,79,87130,181,normal,-
1823206974142102730,10.0.2.15,142.250.27.154,443,tcp,tls,30897,53525,153,18272,141,71797,294,normal,-
-3840513775052187527,10.0.2.15,77.75.78.36,443,tcp,tls,108116,14387,45,6188,46,20575,91,normal,-
-6700777176380795954,10.0.2.15,77.75.78.209,443,tcp,tls,90815,146737,148,9943,118,156680,266,normal,-
-5606325723770913206,10.0.2.15,91.228.74.168,443,tcp,tls,604,8846,22,2898,22,11744,44,normal,-
8301231113082489726,10.0.2.15,34.107.148.139,443,tcp,tls,465320,41556,145,42389,143,83945,288,normal,-
-3393421092851135495,10.0.2.15,3.66.33.201,443,tcp,tls,34016,15908,46,6834,40,22742,86,normal,-
7932034277018374829,10.0.2.15,76.223.111.18,443,tcp,tls,521867,52430,129,19003,132,71433,261,normal,-
1226415506931776899,10.0.2.15,216.239.34.21,443,tcp,tls,794838,278173,297,23785,224,301958,521,normal,-
-1468079914884219322,10.0.2.15,13.32.110.104,443,tcp,tls,341734,21352,52,5640,48,26992,100,normal,-
7251263451850509582,10.0.2.15,52.57.32.9,443,tcp,tls,341776,15550,50,9688,50,25238,100,normal,-
-1606343739490448486,10.0.2.15,104.16.86.20,443,udp,-,2577,363900,343,20846,102,384746,445,normal,-
928680538271586373,10.0.2.15,18.66.15.92,443,tcp,tls,341760,35398,54,4980,48,40378,102,normal,-
-6193189392844125623,10.0.2.15,104.16.169.131,443,tcp,tls,619,12251,32,4164,32,16415,64,normal,-
4060677727791432705,10.0.2.15,104.18.0.175,443,tcp,tls,342356,432658,332,12070,172,444728,504,normal,-
-366475458234225429,10.0.2.15,3.71.149.231,443,tcp,tls,535653,25785,92,15193,94,40978,186,normal,-
36315074516517358,10.0.2.15,34.242.3.5,443,tcp,tls,342730,39854,56,5766,58,45620,114,normal,-
-4104352759984710221,10.0.2.15,162.159.137.232,443,tcp,tls,672,35428,48,4316,36,39744,84,normal,-
4140080995294034495,10.0.2.15,104.16.168.131,443,tcp,tls,2453,209593,218,16239,153,225832,371,normal,-
-3745977496428519662,10.0.2.15,142.250.27.157,443,tcp,-,173879,27031,81,9777,80,36808,161,normal,-
-7213428034139376362,10.0.2.15,13.32.110.122,443,tcp,tls,44276,206737,175,8066,85,214803,260,normal,-
8451439613896208482,10.0.2.15,172.64.166.9,443,tcp,tls,42381,53841,96,10671,88,64512,184,normal,-
-8740281930116363717,10.0.2.15,192.243.59.20,443,tcp,tls,54902,31459,75,10956,71,42415,146,normal,-
467458680053151959,10.0.2.15,104.64.175.239,443,tcp,tls,231494,12106,50,4724,46,16830,96,normal,-
5693520643448559679,10.0.2.15,104.18.1.175,443,tcp,tls,513351,558552,426,16436,235,574988,661,normal,-
7807032808820637970,10.0.2.15,142.251.36.150,443,tcp,tls,6481,802818,680,37396,468,840214,1148,normal,-
-1332919605598919102,10.0.2.15,192.243.61.227,443,tcp,tls,21268,11906,28,3528,26,15434,54,normal,-
-6860391639645555359,10.0.2.15,217.16.184.49,443,tcp,tls,3068,12968,32,5138,30,18106,62,normal,-
4273912021926130652,10.0.2.15,104.18.5.32,443,tcp,tls,45082,585788,433,20807,316,606595,749,normal,-
7311999010844107823,10.0.2.15,104.26.9.169,443,tcp,tls,353056,40625,83,7179,76,47804,159,normal,-
-1165359330551500015,10.0.2.15,18.159.6.58,443,tcp,tls,85645,21756,56,6536,56,28292,112,normal,-
9217870203413956269,10.0.2.15,157.90.33.78,443,tcp,tls,2486,12584,36,5180,36,17764,72,normal,-
-5877953867382976994,10.0.2.15,104.21.235.45,443,tcp,tls,520,12762,24,3028,26,15790,50,normal,-
4398201005277991429,10.0.2.15,178.162.128.4,443,tcp,tls,38524,94280,86,6510,76,100790,162,normal,-
4726737569039146399,10.0.2.15,77.75.78.20,443,tcp,tls,154250,16620,36,4706,36,21326,72,normal,-
4401227279911548430,10.0.2.15,77.75.77.222,443,tcp,tls,352850,237522,230,20000,166,257522,396,normal,-
-8127519155471817115,10.0.2.15,95.211.229.247,443,tcp,tls,13610,27482,64,16311,62,43793,126,normal,-
-8976110269810168982,10.0.2.15,2.23.8.228,443,tcp,tls,365066,358553,299,19206,225,377759,524,normal,-
6086018342659049593,10.0.2.15,192.0.77.2,443,tcp,tls,159637,323026,295,18914,215,341940,510,normal,-
-511744065404283578,10.0.2.15,18.208.40.77,80,tcp,http,1160,1908,12,2792,14,4700,26,normal,-
-9201636140805585211,10.0.2.15,13.32.10.16,443,tcp,tls,341872,18024,48,7744,48,25768,96,normal,-
-2010488356499604637,10.0.2.15,104.16.125.175,443,tcp,tls,101148,479445,399,21322,268,500767,667,normal,-
-765894103617322855,10.0.2.15,162.159.135.234,443,tcp,tls,18760,28956,44,6850,44,35806,88,normal,-
5080558933712880620,10.0.2.15,142.251.37.106,443,tcp,tls,386090,97271,161,18135,157,115406,318,normal,-
7936230341361872198,10.0.2.15,77.75.76.101,443,tcp,tls,90801,53024,62,4741,46,57765,108,normal,-
-4064118875612245948,10.0.2.15,151.101.2.217,443,tcp,tls,387344,52112,89,8539,77,60651,166,normal,-
-2217661666991881233,10.0.2.15,77.75.79.115,443,tcp,tls,401110,77129,93,7798,77,84927,170,normal,-
-2286726792714893439,10.0.2.15,192.243.59.13,443,tcp,tls,42366,38687,81,21718,76,60405,157,normal,-
5364708961673686432,10.0.2.15,162.159.133.233,443,tcp,tls,150058,15140,40,4528,36,19668,76,normal,-
-4961804429323015978,10.0.2.15,172.64.108.35,443,tcp,tls,844,67426,70,5152,54,72578,124,normal,-
-8317488137449033062,10.0.2.15,104.21.235.46,443,tcp,tls,71680,26547,51,6429,53,32976,104,normal,-
-5268522240333264503,10.0.2.15,18.119.54.102,443,tcp,tls,343012,20096,50,5218,48,25314,98,normal,-
1177052545159681754,10.0.2.15,162.159.128.233,443,tcp,tls,154606,10896,32,4124,32,15020,64,normal,-
1174789062196390833,10.0.2.15,77.75.76.209,443,tcp,tls,65004,185128,180,12050,144,197178,324,normal,-
-5825227034641019004,10.0.2.15,157.90.4.17,443,tcp,tls,4446,21964,40,4128,32,26092,72,normal,-
-6859120467604942241,10.0.2.15,104.17.32.105,443,tcp,tls,350100,285110,280,18536,186,303646,466,normal,-
1954119892915932219,10.0.2.15,104.16.123.175,443,tcp,tls,76261,35661,60,6608,50,42269,110,normal,-
-1616376830308395668,10.0.2.15,88.212.202.52,443,tcp,tls,48792,9298,30,5270,30,14568,60,normal,-
6091183835650936101,10.0.2.15,16.170.45.0,443,tcp,tls,23858,17176,32,4038,34,21214,66,normal,-
-860977875910101040,10.0.2.15,13.32.110.79,443,tcp,tls,44618,21370,40,4336,38,25706,78,normal,-
8375409224164535179,10.0.2.15,142.251.36.134,443,tcp,tls,173590,105377,141,12330,114,117707,255,normal,-
-4806717530272152932,10.0.2.15,13.32.110.80,443,tcp,tls,343376,148694,140,8484,100,157178,240,normal,-
1295242341369933176,10.0.2.15,216.239.38.21,443,tcp,tls,957108,500386,464,29734,284,530120,748,normal,-
8624369979833572644,10.0.2.15,104.21.11.9,443,tcp,tls,82702,10998,34,4156,32,15154,66,normal,-
6553928390248878813,10.0.2.15,51.195.4.167,8443,tcp,tls,7906,24728,58,12624,56,37352,114,normal,-
-8879629049438583091,10.0.2.15,104.19.149.54,443,tcp,tls,364867,176348,175,10677,108,187025,283,normal,-
2170530550808096470,10.0.2.15,142.251.36.136,443,tcp,tls,113154,322441,267,15201,212,337642,479,normal,-
-2769173408735111957,10.0.2.15,185.199.111.154,443,tcp,tls,26597,11864,56,6570,80,18434,136,normal,-
4783513458877169362,10.0.2.15,87.250.250.119,443,tcp,tls,73448,329656,284,19040,180,348696,464,normal,-
6630239922261311904,10.0.2.15,173.233.137.60,443,tcp,tls,36263,76132,82,7371,76,83503,158,normal,-
5902569400811702811,10.0.2.15,138.199.36.11,443,tcp,tls,81418,13962,32,4152,34,18114,66,normal,-
-600785315809157125,10.0.2.15,104.18.10.47,443,tcp,tls,418250,70858,99,10610,73,81468,172,normal,-
-1878396780421241556,10.0.2.15,140.82.121.4,443,tcp,tls,26470,620482,490,32540,444,653022,934,normal,-
8979014989194730212,10.0.2.15,3.69.185.50,443,tcp,tls,20740,25142,38,5676,38,30818,76,normal,-
-4169716658038795236,10.0.2.15,172.67.204.243,443,tcp,tls,870,16382,34,4210,30,20592,64,normal,-
3986276023458719028,10.0.2.15,140.82.113.22,443,tcp,tls,23974,10840,38,6274,38,17114,76,normal,-
2246088469286651116,10.0.2.15,95.128.201.169,443,tcp,tls,68011,26062,64,10889,66,36951,130,normal,-
9119403799285782955,10.0.2.15,13.32.110.2,443,tcp,tls,343282,251486,208,8686,108,260172,316,normal,-
4987594836485998808,10.0.2.15,77.75.78.157,443,tcp,tls,513722,208820,219,13829,156,222649,375,normal,-
-4951740880007752036,10.0.2.15,140.82.112.26,443,tcp,tls,9472,9150,32,5972,30,15122,62,normal,-
3478393672119446805,10.0.2.15,54.155.30.83,443,tcp,tls,24073,27662,51,6786,53,34448,104,normal,-
2970876527556364171,10.0.2.15,18.66.15.101,443,tcp,tls,341848,23424,48,4896,44,28320,92,normal,-
-7271011191542520234,10.0.2.15,104.18.2.114,443,tcp,tls,512759,19037,74,32479,72,51516,146,normal,-
6982274115473372854,10.0.2.15,8.8.8.8,443,tcp,tls,15666,15052,42,4844,40,19896,82,normal,-
7705909610798210908,10.0.2.15,77.75.79.129,443,tcp,tls,107895,18152,38,4524,40,22676,78,normal,-
-4743056326157069287,10.0.2.15,212.18.101.1,443,tcp,tls,114251,1823175,1337,72360,1164,1895535,2501,normal,-
5800417411304520135,10.0.2.15,104.16.168.131,443,udp,-,11673,587097,536,62389,168,649486,704,normal,-
3865035306195767353,10.0.2.15,18.156.18.132,3478,udp,-,670,1166,11,682,11,1848,22,normal,-
-2509380242028309596,10.0.2.15,172.67.204.243,443,udp,-,15524,19432,34,5704,22,25136,56,normal,-
2837388961170167394,10.0.2.15,162.159.128.233,443,udp,-,246,12916,18,4042,12,16958,30,normal,-
5233468279784835734,10.0.2.15,35.244.159.8,443,udp,-,7304,32548,57,17396,55,49944,112,normal,-
-8334968043802857494,10.0.2.15,172.64.166.9,443,udp,-,436,15770,26,3846,12,19616,38,normal,-
6474633842011000188,10.0.2.15,108.177.119.127,19302,udp,-,878,1036,14,868,14,1904,28,normal,-
-8312518419511593786,10.0.2.15,67.197.233.183,53481,udp,-,3002,0,0,1380,10,1380,10,normal,-
-8162037677865493332,10.0.2.15,104.21.11.9,443,udp,-,412,13014,20,3664,10,16678,30,normal,-
-6657151721438547422,10.0.2.15,104.21.235.46,443,udp,-,55571,2964606,2586,103275,647,3067881,3233,normal,-
-8979374848878428006,10.0.2.15,142.251.36.150,443,udp,-,5354,690877,564,36071,227,726948,791,normal,-
-8410998433534530797,10.0.2.15,142.251.36.134,443,udp,-,3053,216708,176,14426,68,231134,244,normal,-
8642610531483858494,10.0.2.15,8.8.8.8,443,udp,-,550,22547,24,6127,23,28674,47,normal,-
-2444016343974224581,10.0.2.15,162.159.137.232,443,udp,-,66214,19665136,16408,524404,3028,20189540,19436,normal,-
-337589620972102116,10.0.2.15,173.233.137.44,80,tcp,http,42709,11832,33,11246,34,23078,67,normal,-
-5653492196005942999,10.0.2.15,95.82.134.75,10535,udp,-,3002,0,0,1380,10,1380,10,normal,-
3830866966818582110,10.0.2.15,142.251.36.136,443,udp,-,1230,227107,182,10177,67,237284,249,normal,-
-4217617451372491354,10.0.2.15,104.21.235.45,443,udp,-,320,17948,24,4412,16,22360,40,normal,-
8757102855386072751,10.0.2.15,44.226.72.95,443,tcp,-,450,832,12,672,10,1504,22,normal,-
-99938854785783691,10.0.2.15,31.220.24.153,80,tcp,http,60520,1454,14,3392,14,4846,28,normal,-
878043574543336886,10.0.2.15,142.250.102.157,443,udp,-,448,14432,16,3808,12,18240,28,normal,-
6740895349723366260,10.0.2.15,142.251.37.106,443,udp,-,9732,188379,188,24054,104,212433,292,normal,-
6469636135364479480,10.0.2.15,34.111.234.236,443,udp,-,4913,25159,35,9376,35,34535,70,normal,-
-6394009166945685909,10.0.2.15,104.18.7.57,443,udp,-,499,27165,39,6907,26,34072,65,normal,-
572041049338135492,10.0.2.15,84.47.1.151,65301,udp,-,3006,0,0,1380,10,1380,10,normal,-
-7565459228357378090,10.0.2.15,31.30.161.29,20198,udp,-,3002,0,0,1380,10,1380,10,normal,-
-3301468013312530338,10.0.2.15,172.64.108.35,443,udp,-,364,10844,22,4036,14,14880,36,normal,-
4031071338083910404,10.0.2.15,18.66.15.113,443,udp,-,7758,20998,30,5704,22,26702,52,normal,-
5136016653887172473,10.0.2.15,104.18.6.57,443,udp,-,8176,60344,68,10546,34,70890,102,normal,-
-6590966164004909358,10.0.2.15,34.117.157.22,443,udp,-,346,11954,14,3802,12,15756,26,normal,-
7025045377684172072,10.0.2.15,162.159.133.233,443,udp,-,362,10720,20,3848,12,14568,32,normal,-
1025290280508522569,10.0.2.15,88.212.39.66,58401,udp,-,3004,0,0,1380,10,1380,10,normal,-
-7997823000922973986,10.0.2.15,34.98.64.218,443,udp,-,1118,13360,24,6990,20,20350,44,normal,-
-1679531726456578862,10.0.2.15,197.90.207.73,56170,udp,-,3002,0,0,1420,10,1420,10,normal,-
-2203608059768515759,10.0.2.15,90.180.241.137,60622,udp,-,3002,0,0,1420,10,1420,10,normal,-
8661232133270008487,10.0.2.15,104.17.24.14,443,udp,-,320,10628,18,3666,10,14294,28,normal,-
-4532852976833639983,10.0.2.15,104.16.169.131,443,udp,-,118,8732,8,3762,10,12494,18,normal,-
3483543390152588370,10.0.2.15,142.250.27.154,443,udp,-,37085,40425,79,20676,63,61101,142,normal,-
-4785511280177250355,10.0.2.15,87.248.119.252,443,tcp,tls,3776,46294,94,10584,90,56878,184,normal,-
2265447530504132925,10.0.2.15,18.156.32.70,443,tcp,-,2038,0,0,296,4,296,4,normal,-
3031642172289145740,10.0.2.15,35.157.246.167,443,tcp,tls,118221,38415,100,16766,95,55181,195,normal,-
1865804095156092049,10.0.2.15,3.75.3.113,443,tcp,-,112,120,2,148,2,268,4,normal,-
8995489783662163736,10.0.2.15,216.52.2.91,443,tcp,tls,3944,12542,16,2046,18,14588,34,normal,-
-6525121752973734406,10.0.2.15,23.195.249.162,443,tcp,tls,332655,686744,704,64057,567,750801,1271,normal,-
-1396727892673524156,10.0.2.15,188.125.72.139,443,tcp,tls,176934,37186,118,29035,110,66221,228,normal,-
8781981507087767350,10.0.2.15,87.248.119.251,443,tcp,tls,355466,1133591,999,57775,540,1191366,1539,normal,-
-5231865469018052090,10.0.2.15,40.114.177.156,443,tcp,tls,21940,409192,351,22438,302,431630,653,normal,-
-1258713125420562776,10.0.2.15,46.228.164.11,443,tcp,tls,15906,13484,34,4764,32,18248,66,normal,-
5871898672794496687,10.0.2.15,193.0.160.130,443,tcp,tls,3144,13554,22,2622,24,16176,46,normal,-
-228285238436887425,10.0.2.15,142.251.36.109,443,tcp,tls,3059,268179,252,14390,143,282569,395,normal,-
-2273209490867440739,10.0.2.15,3.64.121.24,443,tcp,tls,29444,15300,40,6344,40,21644,80,normal,-
6179870216965430052,10.0.2.15,52.223.40.198,443,tcp,tls,236709,37311,97,17256,97,54567,194,normal,-
-3876042540605617107,10.0.2.15,37.252.171.53,443,tcp,tls,22646,14822,34,6932,30,21754,64,normal,-
7210756389712984527,10.0.2.15,69.173.144.165,443,tcp,tls,204256,14782,44,5506,40,20288,84,normal,-
3795028978805959298,10.0.2.15,54.77.25.239,443,tcp,tls,4838,8876,24,3072,24,11948,48,normal,-
-5031853839865620233,10.0.2.15,152.199.22.11,443,tcp,tls,173318,244850,207,12727,180,257577,387,normal,-
3849843737783833493,10.0.2.15,192.229.221.24,443,tcp,tls,172303,19827,50,5501,47,25328,97,normal,-
1548563159018738015,10.0.2.15,23.195.248.48,443,tcp,tls,581045,144582,205,15461,173,160043,378,normal,-
5101551572718607192,10.0.2.15,142.251.36.97,443,tcp,tls,101011,202404,274,26224,244,228628,518,normal,-
6899789545136116380,10.0.2.15,54.230.112.100,443,tcp,-,223716,1120,16,1202,16,2322,32,normal,-
-6431456726436995467,10.0.2.15,3.75.62.37,443,tcp,tls,258,3284,8,1614,10,4898,18,normal,-
-6252791246654944560,10.0.2.15,91.228.74.244,443,tcp,tls,189078,32142,80,15638,77,47780,157,normal,-
-344197347259473488,10.0.2.15,104.18.21.226,80,tcp,http,1620293,91378,299,35464,310,126842,609,normal,-
-8241134419686413656,10.0.2.15,54.230.112.55,443,tcp,tls,341916,196794,168,7838,100,204632,268,normal,-
1271665853105689731,10.0.2.15,87.248.100.214,443,tcp,tls,356124,1164634,914,46044,502,1210678,1416,normal,-
-923799643690377455,10.0.2.15,185.64.190.79,443,tcp,tls,346444,19630,60,11802,60,31432,120,normal,-
3374930965768669272,10.0.2.15,152.199.23.180,443,tcp,tls,343986,27706,54,6706,50,34412,104,normal,-
470953739364276910,10.0.2.15,178.250.1.7,443,tcp,tls,32030,15825,50,7660,46,23485,96,normal,-
1987660939496199851,10.0.2.15,3.8.30.242,443,tcp,tls,342590,9984,38,4822,38,14806,76,normal,-
6349858444105599074,10.0.2.15,52.48.98.99,443,tcp,-,175072,6863,31,7934,33,14797,64,normal,-
1940379466543456414,10.0.2.15,34.250.191.205,443,tcp,tls,345986,19926,64,8106,62,28032,126,normal,-
4519671193527232010,10.0.2.15,185.29.132.245,443,tcp,tls,166776,12126,42,6576,42,18702,84,normal,-
-2538948103889304079,10.0.2.15,18.158.8.202,443,tcp,-,2048,0,0,296,4,296,4,normal,-
-5932859721030104546,10.0.2.15,52.17.153.19,443,tcp,tls,128018,30906,56,8932,46,39838,102,normal,-
5136777481733540542,10.0.2.15,34.252.136.84,443,tcp,tls,131086,19278,48,9546,46,28824,94,normal,-
5743270448457154117,10.0.2.15,104.64.122.89,443,tcp,tls,230630,14718,52,6248,50,20966,102,normal,-
1432051177573598215,10.0.2.15,142.251.36.109,443,udp,-,33586,331260,359,54243,185,385503,544,normal,-
-8057618571749786613,10.0.2.15,54.230.106.86,80,tcp,http,346916,5634,48,4113,51,9747,99,normal,-
3567530931024850446,10.0.2.15,54.230.112.86,443,tcp,tls,341402,16208,48,6120,46,22328,94,normal,-
5628754903003744281,10.0.2.15,95.100.146.57,80,tcp,-,412851,14911,72,9112,74,24023,146,normal,-
6761887988729092832,10.0.2.15,142.251.36.97,443,udp,-,89255,1713287,1406,150646,591,1863933,1997,normal,-
1192033214912591561,10.0.2.15,185.125.188.59,443,tcp,tls,11708,62866,82,31372,56,94238,138,normal,-
5923705915153118200,10.0.2.15,54.230.112.16,443,tcp,tls,343080,36810,58,5664,58,42474,116,normal,-
-2871759237791074501,10.0.2.15,35.201.103.21,443,tcp,tls,511395,22701,62,7029,62,29730,124,normal,-
-4401125593021092847,10.0.2.15,37.157.4.23,443,tcp,tls,242102,14128,42,6530,40,20658,82,normal,-
-595053205293048998,10.0.2.15,192.124.249.24,80,tcp,http,318196,27077,72,8199,73,35276,145,normal,-
1071397530641690402,10.0.2.15,185.10.104.109,443,tcp,tls,62434,79459,121,13264,114,92723,235,normal,-
-5162431368148535450,10.0.2.15,107.22.42.120,443,tcp,tls,342592,13980,42,5870,42,19850,84,normal,-
6383430682229926770,10.0.2.15,110.242.69.147,80,tcp,http,38554,15444,48,5226,56,20670,104,normal,-
-7881388759959553794,54.70.68.230,10.0.2.15,50046,tcp,-,5028,711,10,851,12,1562,22,normal,-
-8429723423367824502,10.0.2.15,216.58.214.67,443,udp,-,1771,23920,28,8123,31,32043,59,normal,-
982676291431859946,10.0.2.15,152.195.51.15,443,tcp,tls,342010,21536,52,6384,44,27920,96,normal,-
-8380756608460875869,10.0.2.15,95.100.146.66,80,tcp,http,1524236,72645,284,42543,291,115188,575,normal,-
-4578908315121745022,10.0.2.15,15.197.179.228,443,tcp,tls,231764,13766,52,7316,50,21082,102,normal,-
764724690222512856,10.0.2.15,54.172.140.92,443,tcp,tls,343134,12270,48,12028,50,24298,98,normal,-
8356684234331241474,10.0.2.15,216.58.214.67,443,tcp,tls,342030,19306,46,5912,44,25218,90,normal,-
-4058167919676652978,10.0.2.15,95.163.41.56,443,tcp,tls,19507,178195,282,35285,250,213480,532,normal,-
-4607309632793157535,10.0.2.15,104.193.88.77,80,tcp,http,363808,207148,199,12126,166,219274,365,normal,-
8261945619360487197,10.0.2.15,87.250.250.90,443,tcp,tls,172388,15850,47,5406,44,21256,91,normal,-
4413230234998503306,10.0.2.15,95.163.61.136,443,tcp,tls,364765,242396,331,41153,298,283549,629,normal,-
6010876352846927135,10.0.2.15,178.154.131.216,443,tcp,tls,347995,304999,301,20336,217,325335,518,normal,-
882264057769677774,10.0.2.15,95.163.52.80,443,tcp,tls,24254,820472,648,42107,551,862579,1199,normal,-
-6919326372368240384,10.0.2.15,152.195.39.165,443,tcp,tls,341814,15432,50,5320,44,20752,94,normal,-
1862511941882422483,10.0.2.15,175.6.243.38,80,tcp,http,7894,6716,15,1896,16,8612,31,normal,-
-2118939456558782968,10.0.2.15,35.204.158.49,443,tcp,tls,341986,12472,42,5538,38,18010,80,normal,-
8086387748446032377,10.0.2.15,35.157.25.58,443,tcp,tls,340976,17238,52,7130,50,24368,102,normal,-
7915628432955631380,10.0.2.15,18.156.0.31,443,tcp,tls,343072,59108,80,11482,80,70590,160,normal,-
-6312798750277017692,10.0.2.15,95.163.54.50,443,tcp,tls,174252,23747,58,7316,58,31063,116,normal,-
832926983236326523,10.0.2.15,23.195.248.203,443,tcp,tls,263008,11639184,8350,160504,2082,11799688,10432,normal,-
914398524639177398,10.0.2.15,199.59.243.223,80,tcp,http,96006,62386,84,16473,69,78859,153,normal,-
3688908316851394196,10.0.2.15,95.100.146.24,443,tcp,tls,131896,6061738,4395,125530,1844,6187268,6239,normal,-
-2830350126044225105,10.0.2.15,95.163.43.46,443,tcp,tls,62236,22707,66,10442,56,33149,122,normal,-
-8231369249106979268,10.0.2.15,144.2.9.1,443,tcp,tls,1270,8450,22,2510,22,10960,44,normal,-
22759388108740768,10.0.2.15,5.181.61.0,443,tcp,tls,139875,369341,327,21167,267,390508,594,normal,-
161202858425149682,10.0.2.15,52.84.151.14,443,tcp,tls,134891,600080,469,18947,234,619027,703,normal,-
1031486221072832264,10.0.2.15,39.156.66.10,80,tcp,http,188124,2380,27,2254,28,4634,55,normal,-
6334199219376600293,10.0.2.15,162.159.153.247,443,tcp,tls,3987,101029,207,24686,204,125715,411,normal,-
-1011017496625007186,10.0.2.15,18.165.228.253,443,tcp,tls,16337,2308104,1769,55938,650,2364042,2419,normal,-
8107367719059144157,10.0.2.15,185.10.104.115,80,tcp,http,480470,563216,447,23446,409,586662,856,normal,-
8999318017129529748,10.0.2.15,217.69.135.203,443,tcp,tls,536559,42731,157,23011,148,65742,305,normal,-
-2228324251369599002,10.0.2.15,34.98.75.36,443,tcp,tls,513339,20391,65,7353,67,27744,132,normal,-
4838452122729081685,10.0.2.15,94.100.180.201,80,tcp,http,186676,2448,29,2358,30,4806,59,normal,-
2005277348751567253,10.0.2.15,142.251.36.131,80,tcp,http,658016,12767,97,9865,102,22632,199,normal,-
5410392023404425299,10.0.2.15,88.212.201.204,443,tcp,tls,1178,6958,16,2298,18,9256,34,normal,-
-6666116481899061970,10.0.2.15,162.159.152.17,443,tcp,tls,2742,1677852,1214,49727,766,1727579,1980,normal,-
-7253554247940972360,10.0.2.15,193.0.170.54,443,tcp,tls,11382,11220,26,5918,26,17138,52,normal,-
5711999820994803169,10.0.2.15,146.75.116.84,443,tcp,tls,3103,16372,34,5811,38,22183,72,normal,-
3325946097260039586,10.0.2.15,77.75.78.196,443,tcp,tls,453918,278964,333,57491,239,336455,572,normal,-
-3281590182162856005,10.0.2.15,213.180.204.90,443,tcp,tls,350412,17284,84,11362,78,28646,162,normal,-
-292561021347683914,10.0.2.15,87.250.251.119,443,tcp,tls,353972,242198,222,15640,188,257838,410,normal,-
-3167768419272214342,10.0.2.15,108.156.31.244,443,tcp,tls,270702,354868,278,14420,212,369288,490,normal,-
-2773287932430237843,10.0.2.15,18.172.153.107,443,tcp,tls,403065,90885,114,9331,101,100216,215,normal,-
6151543148825139957,10.0.2.15,87.230.98.74,443,tcp,tls,4396,19808,45,6632,45,26440,90,normal,-
4090637332096591173,10.0.2.15,144.2.12.25,443,tcp,tls,464583,84978,187,69648,181,154626,368,normal,-
-1170440158000728433,10.0.2.15,185.5.137.182,443,tcp,tls,348150,21152,78,21908,81,43060,159,normal,-
-7774140715962310105,10.0.2.15,95.163.52.89,443,tcp,tls,19264,16102,35,5689,39,21791,74,normal,-
-6694151532782616073,10.0.2.15,54.197.243.175,443,tcp,tls,122438,12660,38,4484,40,17144,78,normal,-
9157463694801207809,10.0.2.15,213.180.204.36,443,tcp,tls,234312,13636,52,4922,50,18558,102,normal,-
-663279750240076821,10.0.2.15,141.95.47.53,443,tcp,tls,168212,23554,96,16662,98,40216,194,normal,-
-2721789583145599593,10.0.2.15,52.21.149.172,443,tcp,tls,15752,12176,30,3910,28,16086,58,normal,-
-2372453214117770861,10.0.2.15,194.226.130.229,443,tcp,tls,245260,35614,96,11173,97,46787,193,normal,-
4417102280546297474,10.0.2.15,18.244.179.61,443,tcp,tls,163921,45852,88,9921,84,55773,172,normal,-
4104263817951994357,10.0.2.15,217.69.139.211,443,tcp,tls,185696,256377,223,12786,165,269163,388,normal,-
6302146419402086606,10.0.2.15,217.69.133.168,443,tcp,tls,150796,492132,366,16708,268,508840,634,normal,-
5379243030778231008,10.0.2.15,170.114.52.2,443,tcp,tls,271302,175448,156,8956,96,184404,252,normal,-
-5393814279841062842,10.0.2.15,151.101.194.132,443,tcp,tls,395776,25559,73,11967,68,37526,141,normal,-
-7402231422624871250,10.0.2.15,87.250.247.183,443,tcp,tls,345553,145786,158,11048,129,156834,287,normal,-
398110810038710311,10.0.2.15,185.152.65.26,443,tcp,tls,342456,292780,242,10758,142,303538,384,normal,-
-694220641064655394,10.0.2.15,3.211.81.213,443,tcp,tls,4622,11408,30,4868,30,16276,60,normal,-
-6444139448489550713,10.0.2.15,77.75.76.20,443,tcp,tls,104201,17321,29,3706,32,21027,61,normal,-
2178892403512001809,10.0.2.15,3.213.210.216,443,tcp,tls,73894,19890,47,5962,48,25852,95,normal,-
2426813373750929686,10.0.2.15,151.101.128.84,443,tcp,tls,341472,15082,44,4798,42,19880,86,normal,-
-6405318247891706892,10.0.2.15,104.96.92.79,443,tcp,tls,420829,29919,78,9188,74,39107,152,normal,-
3134442569795615577,10.0.2.15,31.30.189.204,443,tcp,tls,16669,396419,299,14088,138,410507,437,normal,-
2577987375067226609,10.0.2.15,52.84.150.39,443,tcp,tls,329122,4983922,4230,181522,2062,5165444,6292,normal,-
-545910649855569662,10.0.2.15,151.101.0.84,443,tcp,tls,6478,14362,34,4138,32,18500,66,normal,-
-7745871645771520774,10.0.2.15,143.204.215.96,443,tcp,tls,266232,112850,110,6462,74,119312,184,normal,-
-3575414821359551282,10.0.2.15,2.16.2.192,443,tcp,tls,614795,1854979,1487,60939,766,1915918,2253,normal,-
5624518986595161242,10.0.2.15,217.69.139.200,443,tcp,tls,196600,307630,350,76520,306,384150,656,normal,-
2928255367640824193,10.0.2.15,31.30.189.12,443,tcp,tls,7571,22669,36,4827,40,27496,76,normal,-
5643353699800560933,10.0.2.15,104.96.94.148,443,tcp,tls,230968,12220,50,4644,46,16864,96,normal,-
-1056498574412507179,10.0.2.15,34.98.108.207,443,tcp,tls,1340,29310,46,4510,40,33820,86,normal,-
3861654636499826813,10.0.2.15,5.255.255.80,443,tcp,tls,350754,360760,342,44352,232,405112,574,normal,-
-7807544054998441877,10.0.2.15,3.226.41.42,443,tcp,tls,4940,11648,34,4688,32,16336,66,normal,-
-3716795779657386108,10.0.2.15,185.5.137.234,443,tcp,tls,343834,10320,40,4804,38,15124,78,normal,-
-6345915188556298983,10.0.2.15,146.59.30.96,443,tcp,tls,167144,20590,46,4906,38,25496,84,normal,-
9082251662435431865,10.0.2.15,95.163.52.67,443,tcp,tls,256301,105011,168,23483,137,128494,305,normal,-
7017659973512736058,10.0.2.15,217.69.139.101,443,tcp,tls,345128,180014,156,10466,132,190480,288,normal,-
-805627343674389026,10.0.2.15,34.237.219.119,443,tcp,tls,234286,16474,52,5886,50,22360,102,normal,-
-2583587634348914381,10.0.2.15,94.100.180.59,443,tcp,tls,61434,11972,32,6236,32,18208,64,normal,-
5543180827056925206,10.0.2.15,143.204.72.5,80,tcp,http,1101447,40318,186,23848,197,64166,383,normal,-
7994535635387085933,10.0.2.15,162.159.153.247,443,udp,-,1293,54647,71,14479,49,69126,120,normal,-
5349244732861879836,10.0.2.15,95.100.146.24,443,udp,-,1844,13592,20,3946,14,17538,34,normal,-
649318919385478454,10.0.2.15,18.165.228.253,443,udp,-,3064,1438327,994,41199,238,1479526,1232,normal,-
4588591783651309833,10.0.2.15,31.30.189.12,443,udp,-,1198,518332,388,16726,116,535058,504,normal,-
4794778985806101217,10.0.2.15,31.30.189.204,443,udp,-,4534,3230200,2344,59906,594,3290106,2938,normal,-
1228789193552940891,10.0.2.15,170.114.52.2,80,tcp,http,237540,3990,35,2790,38,6780,73,normal,-
-5005780065888576330,10.0.2.15,162.159.152.17,443,udp,-,13115,2041489,1766,157426,518,2198915,2284,normal,-
603837841597978461,10.0.2.15,34.98.108.207,443,udp,-,404,11510,14,3800,12,15310,26,normal,-
2111530821621104541,10.0.2.15,66.254.114.41,443,tcp,tls,64956,153350,155,13022,120,166372,275,normal,-
6146329560928917874,10.0.2.15,64.210.135.113,443,tcp,tls,18065,237303,242,16018,143,253321,385,normal,-
584907946131117128,10.0.2.15,205.185.208.142,443,tcp,tls,175515,552614,495,30199,349,582813,844,normal,-
8236076090720957907,10.0.2.15,172.64.150.233,443,tcp,tls,349425,8128397,5903,129066,1724,8257463,7627,normal,-
7770664006752157799,10.0.2.15,205.185.208.79,443,tcp,tls,171769,69686,84,6487,62,76173,146,normal,-
8785520794212743042,10.0.2.15,2.19.126.216,443,tcp,tls,26110,2794877,2013,44718,606,2839595,2619,normal,-
3848491791893963238,10.0.2.15,104.18.37.23,443,tcp,tls,3926,37171,103,12762,101,49933,204,normal,-
-7214471697499094049,10.0.2.15,205.185.208.20,443,tcp,tls,14122,816517,597,22756,318,839273,915,normal,-
-7315168616364648487,10.0.2.15,216.18.168.30,443,tcp,tls,121516,20668,44,6712,42,27380,86,normal,-
9085366243833339536,10.0.2.15,151.101.194.109,443,tcp,tls,345730,969707,812,38895,474,1008602,1286,normal,-
-2959888547903144755,10.0.2.15,23.195.249.79,443,tcp,tls,717266,2753111,2052,84382,1173,2837493,3225,normal,-
-5781360542135750334,10.0.2.15,188.184.103.157,80,tcp,http,17937,1503,15,870,15,2373,30,normal,-
-6938582900922414312,10.0.2.15,66.254.114.171,443,tcp,tls,121112,30842,52,5612,40,36454,92,normal,-
-2103829838510739475,10.0.2.15,34.102.232.32,443,tcp,tls,2393,41893,68,6696,61,48589,129,normal,-
-5107607889485625973,10.0.2.15,34.95.69.49,443,tcp,tls,195397,32365,85,10786,85,43151,170,normal,-
1827698371751004013,10.0.2.15,34.123.130.65,443,tcp,tls,76987,50800,107,12612,107,63412,214,normal,-
615379893796884526,10.0.2.15,34.223.124.45,80,tcp,http,17480,8717,26,4042,24,12759,50,normal,-
-1570841156856873181,10.0.2.15,213.19.147.42,443,tcp,tls,18233,29944,74,12597,69,42541,143,normal,-
7336321862119894928,10.0.2.15,162.19.138.83,443,tcp,tls,37328,34648,84,13853,77,48501,161,normal,-
-153808852547052280,10.0.2.15,104.18.214.59,443,tcp,tls,2915,172358,157,11057,130,183415,287,normal,-
2000031650509420201,10.0.2.15,18.66.122.62,443,tcp,tls,174530,649216,518,22828,293,672044,811,normal,-
8511690228901446274,10.0.2.15,23.73.140.140,443,tcp,tls,798636,3306718,3168,199464,2253,3506182,5421,normal,-
-637684752492445979,10.0.2.15,104.18.24.185,443,tcp,tls,64137,40034,122,42223,120,82257,242,normal,-
4970958473361591208,10.0.2.15,151.101.192.81,443,tcp,tls,172106,135496,149,10403,101,145899,250,normal,-
3713610831569068202,10.0.2.15,23.195.248.184,443,tcp,tls,145414,2422225,1860,59985,701,2482210,2561,normal,-
-5959075302891712421,10.0.2.15,151.139.128.10,443,tcp,tls,690133,181478,259,22333,210,203811,469,normal,-
4485002249029471420,10.0.2.15,3.67.110.180,443,tcp,tls,19116,37612,113,24839,109,62451,222,normal,-
4390020453067031825,10.0.2.15,18.165.229.62,443,tcp,tls,186788,159451,180,13910,134,173361,314,normal,-
5662229742902256118,10.0.2.15,143.204.191.60,443,tcp,tls,423788,2414942,1939,84546,1103,2499488,3042,normal,-
8921869428491762804,10.0.2.15,34.120.133.55,443,tcp,tls,2851,24486,59,6582,54,31068,113,normal,-
362062426214183428,10.0.2.15,54.76.58.149,443,tcp,tls,180973,61096,101,16838,100,77934,201,normal,-
-2374173679586813159,10.0.2.15,104.87.141.138,443,tcp,tls,125128,121169,126,9438,116,130607,242,normal,-
-4109292632212767105,10.0.2.15,213.19.162.31,443,tcp,tls,29955,46539,114,21990,106,68529,220,normal,-
-944014435158057334,10.0.2.15,54.173.15.238,443,tcp,tls,42642,19858,52,7348,52,27206,104,normal,-
5616550933596318539,10.0.2.15,99.84.9.96,443,tcp,-,7141,391143,296,16357,242,407500,538,normal,-
-4430646069395450547,10.0.2.15,151.101.194.49,443,tcp,-,529968,2904766,2430,173135,1582,3077901,4012,normal,-
4998202892135243465,10.0.2.15,104.18.11.207,443,tcp,tls,1415,19994,40,4723,36,24717,76,normal,-
4385558138523095362,10.0.2.15,108.138.217.197,443,tcp,tls,179137,30806,74,10281,77,41087,151,normal,-
8009898130151463390,10.0.2.15,66.254.114.38,443,tcp,tls,62075,21001,59,8502,60,29503,119,normal,-
2166631580168975308,10.0.2.15,151.101.2.132,80,tcp,http,6822,1402,13,1582,15,2984,28,normal,-
9144278750391771562,10.0.2.15,64.210.135.119,443,tcp,tls,580,8824,24,2856,20,11680,44,normal,-
5467905840281658058,10.0.2.15,52.44.225.90,443,tcp,tls,45644,19237,42,6015,45,25252,87,normal,-
-8542686371576766484,10.0.2.15,18.244.155.28,443,tcp,tls,199527,1496876,1116,39288,556,1536164,1672,normal,-
1788772317190899628,10.0.2.15,188.184.21.108,80,tcp,http,6673,8950,26,3094,28,12044,54,normal,-
1309537346558613090,10.0.2.15,54.194.226.232,443,tcp,tls,37768,48509,78,14254,80,62763,158,normal,-
-3939394064478433179,10.0.2.15,108.156.46.47,443,tcp,tls,3028,68273,77,6029,57,74302,134,normal,-
-6143108514440121629,10.0.2.15,104.64.126.192,443,tcp,tls,233230,154508,154,9388,86,163896,240,normal,-
6371720252066332154,10.0.2.15,152.70.60.241,443,tcp,tls,31975,17817,40,4960,37,22777,77,normal,-
8641816962559161962,10.0.2.15,35.201.125.192,443,tcp,tls,1938,47796,58,4634,42,52430,100,normal,-
8956676939890745589,10.0.2.15,3.227.250.131,443,tcp,tls,24736,28049,58,8642,56,36691,114,normal,-
-203943228733373487,10.0.2.15,104.26.2.70,443,tcp,-,291126,16082,50,6206,52,22288,102,normal,-
4138928132097148090,10.0.2.15,206.189.113.193,443,tcp,tls,73829,178707,166,12544,144,191251,310,normal,-
6960244458480241529,10.0.2.15,188.185.10.243,80,tcp,http,72338,1493,16,1445,18,2938,34,normal,-
-2435385448708082161,10.0.2.15,89.207.16.210,443,tcp,tls,105750,10548,34,4404,34,14952,68,normal,-
1109885678671831502,10.0.2.15,209.197.3.25,443,tcp,tls,20668,47988,56,4322,38,52310,94,normal,-
-149760898587826964,10.0.2.15,104.18.215.59,443,tcp,tls,564,8096,20,2704,20,10800,40,normal,-
-4393086155542067404,10.0.2.15,69.166.1.15,443,tcp,-,579706,0,0,4662,63,4662,63,normal,-
3188237411600111808,10.0.2.15,52.210.15.1,443,tcp,tls,33828,13646,32,5108,34,18754,66,normal,-
3156126587551927136,10.0.2.15,52.51.126.33,443,tcp,tls,96125,34967,88,14216,92,49183,180,normal,-
-2502680974182637204,10.0.2.15,104.17.50.95,443,tcp,tls,34578,84811,148,16459,131,101270,279,normal,-
1224964719413854240,10.0.2.15,17.253.144.10,443,tcp,tls,740,17656,35,5046,37,22702,72,normal,-
2833288241655061372,10.0.2.15,142.251.36.83,443,tcp,tls,229904,28198,72,9635,71,37833,143,normal,-
-5890127479623460385,10.0.2.15,34.160.46.1,443,tcp,tls,1084,11510,32,4246,32,15756,64,normal,-
4684959442509999150,10.0.2.15,104.17.68.176,443,tcp,-,175087,26813,35,3043,33,29856,68,normal,-
3072140259391008405,10.0.2.15,130.211.23.194,443,tcp,tls,289924,38206,96,11505,100,49711,196,normal,-
-1426456416346699174,10.0.2.15,104.19.155.83,443,tcp,tls,4119,17032,47,7156,47,24188,94,normal,-
1305523498015419879,10.0.2.15,3.91.171.131,443,tcp,tls,13530,15230,38,7832,34,23062,72,normal,-
1190881239189762203,10.0.2.15,2.19.126.212,443,tcp,tls,501415,373371,350,15528,182,388899,532,normal,-
-9069483474097796072,10.0.2.15,18.165.242.56,443,tcp,tls,1946,33874,48,4876,48,38750,96,normal,-
-2082941930430073754,10.0.2.15,143.204.191.115,443,tcp,tls,538,13938,26,3028,26,16966,52,normal,-
4800010528673878794,10.0.2.15,23.195.248.142,443,tcp,-,420407,127270,161,11823,113,139093,274,normal,-
-1149704437017263343,10.0.2.15,34.96.112.9,443,tcp,tls,1354,14226,40,5138,38,19364,78,normal,-
-4992178789937900852,10.0.2.15,143.204.68.102,443,tcp,-,223304,1120,16,1202,16,2322,32,normal,-
-7437345759733275139,10.0.2.15,104.16.124.96,443,tcp,tls,680,18634,36,4242,32,22876,68,normal,-
-3866881745919116556,10.0.2.15,104.26.8.169,443,tcp,tls,257090,42721,81,7952,85,50673,166,normal,-
993299720362299481,10.0.2.15,162.19.138.117,443,tcp,tls,18612,18314,47,5565,43,23879,90,normal,-
-2937688395019651842,10.0.2.15,188.185.10.243,443,tcp,tls,1290,79342,80,7262,68,86604,148,normal,-
7231200333631232223,10.0.2.15,216.239.36.54,443,tcp,tls,232811,66936,108,15277,108,82213,216,normal,-
9015133969133196940,10.0.2.15,199.167.73.62,443,tcp,tls,23794,382564,290,10372,142,392936,432,normal,-
1622620450358313522,10.0.2.15,34.110.253.203,443,tcp,tls,172303,63978,82,6907,66,70885,148,normal,-
-379900314558173803,10.0.2.15,18.244.155.63,443,tcp,tls,231630,17872,52,5702,52,23574,104,normal,-
-4279393230267452334,10.0.2.15,13.224.132.96,443,tcp,tls,146394,23786,51,5674,51,29460,102,normal,-
1448569325416738840,10.0.2.15,67.220.243.61,443,tcp,tls,74315,21530,42,5891,44,27421,86,normal,-
8790313393811608278,10.0.2.15,75.2.104.6,443,tcp,tls,52802,15672,44,5654,40,21326,84,normal,-
-4269177950496149090,10.0.2.15,95.100.146.57,443,tcp,tls,87547,862594,681,36658,397,899252,1078,normal,-
4205891414763692308,10.0.2.15,151.101.194.216,80,tcp,http,250,1298,10,1268,10,2566,20,normal,-
2082795253135358846,10.0.2.15,99.83.154.140,443,tcp,tls,174446,21057,49,6077,48,27134,97,normal,-
231596353631693959,10.0.2.15,143.204.192.218,443,tcp,tls,351702,140603,202,19047,176,159650,378,normal,-
914630058450837093,10.0.2.15,13.224.222.43,80,tcp,http,232054,3098,32,2570,34,5668,66,normal,-
879917570412770405,10.0.2.15,209.58.146.243,443,tcp,tls,232546,27116,58,5864,54,32980,112,normal,-
187298431451877637,10.0.2.15,142.251.37.102,443,tcp,tls,172955,99844,135,11916,114,111760,249,normal,-
-9195338051690127044,10.0.2.15,54.239.38.253,443,tcp,tls,232270,19902,54,8516,52,28418,106,normal,-
-7670994410327340509,10.0.2.15,151.101.1.195,443,tcp,tls,172530,35962,69,6965,64,42927,133,normal,-
-7753497406054004933,10.0.2.15,34.111.194.12,443,tcp,tls,380,6536,12,1722,12,8258,24,normal,-
7861608317196445860,10.0.2.15,104.18.20.157,443,tcp,-,132727,31939,190,66875,190,98814,380,normal,-
-8393464521366652924,10.0.2.15,104.18.34.10,443,tcp,tls,3508,149496,124,5994,68,155490,192,normal,-
-154723436452430832,10.0.2.15,23.195.249.173,443,tcp,-,366015,662800,551,33690,427,696490,978,normal,-
-3588246360904340427,10.0.2.15,141.193.213.30,443,tcp,tls,1430,672134,522,31986,474,704120,996,normal,-
-2141144696170036221,10.0.2.15,66.254.114.156,443,tcp,tls,120704,13498,36,4084,36,17582,72,normal,-
5370122436421124479,10.0.2.15,13.32.171.134,443,tcp,tls,513466,90560,109,8480,85,99040,194,normal,-
-8859724056285674156,10.0.2.15,18.244.155.8,80,tcp,http,231564,3378,32,2560,34,5938,66,normal,-
-2848050633533786468,10.0.2.15,104.18.72.113,443,tcp,tls,2605,21529,64,8697,69,30226,133,normal,-
3875084922453359252,10.0.2.15,142.251.36.105,443,tcp,tls,3799,20836,51,6210,50,27046,101,normal,-
7195370933778626697,10.0.2.15,104.19.154.83,443,tcp,tls,172492,13955,45,6269,47,20224,92,normal,-
-6669792195936813399,10.0.2.15,143.204.89.60,443,tcp,tls,172604,75258,85,6476,65,81734,150,normal,-
966860274357147011,10.0.2.15,185.235.87.195,443,tcp,tls,20868,9778,30,3898,30,13676,60,normal,-
-4153918174291904772,10.0.2.15,185.29.134.244,443,tcp,tls,290736,15594,60,6649,66,22243,126,normal,-
-7578322342622221786,10.0.2.15,99.80.27.125,443,tcp,tls,350932,20874,76,17760,76,38634,152,normal,-
919725123005470031,10.0.2.15,18.165.242.69,443,tcp,tls,342736,22880,46,5872,44,28752,90,normal,-
-1137543459704046149,10.0.2.15,104.64.119.207,443,tcp,tls,245419,34726,100,15239,96,49965,196,normal,-
7610467594921294095,10.0.2.15,104.18.70.113,443,tcp,tls,136095,513343,455,25645,285,538988,740,normal,-
1993991008347783273,10.0.2.15,104.17.49.95,443,tcp,tls,171922,361025,343,19383,203,380408,546,normal,-
1890510321350108694,10.0.2.15,18.164.68.69,443,tcp,tls,587289,522112,460,25276,316,547388,776,normal,-
307615167076534757,10.0.2.15,104.22.53.86,443,tcp,tls,342471,86699,101,6998,67,93697,168,normal,-
-2843321275658789348,10.0.2.15,52.222.229.186,443,tcp,tls,2352,175483,160,11443,140,186926,300,normal,-
-3577852746848067037,10.0.2.15,151.101.192.81,80,tcp,http,230588,5014,34,2670,36,7684,70,normal,-
-4718718472139868828,10.0.2.15,52.30.57.148,443,tcp,tls,7722,13036,26,3328,28,16364,54,normal,-
2545190149736238249,10.0.2.15,44.236.48.31,443,tcp,tls,151828,13038,40,4524,40,17562,80,normal,-
-4489493926444234809,10.0.2.15,3.231.35.141,443,tcp,tls,128376,16746,44,12084,46,28830,90,normal,-
-1384561825458871908,10.0.2.15,157.240.30.54,443,tcp,tls,90357,362903,403,30081,293,392984,696,normal,-
-2531680941086925574,10.0.2.15,3.124.173.63,443,tcp,tls,359161,300731,271,24670,220,325401,491,normal,-
-4876046618597485556,10.0.2.15,18.165.201.65,443,tcp,tls,359830,91750,98,6096,62,97846,160,normal,-
290132421197730283,10.0.2.15,185.235.84.73,443,tcp,tls,21590,9882,32,3896,30,13778,62,normal,-
5644261580578972762,10.0.2.15,18.244.114.94,443,tcp,tls,357686,414604,344,15562,200,430166,544,normal,-
-1882976418959249351,10.0.2.15,18.203.174.165,443,tcp,-,183646,21617,44,6235,46,27852,90,normal,-
9115864650387723529,10.0.2.15,23.73.140.155,443,tcp,-,243924,199362,186,11169,140,210531,326,normal,-
-3469506791312441794,10.0.2.15,52.206.0.188,443,tcp,tls,386162,21946,88,17512,86,39458,174,normal,-
5855139542682461999,10.0.2.15,104.16.133.229,443,tcp,tls,580,10354,32,3878,30,14232,62,normal,-
-8199450949075880677,10.0.2.15,95.100.146.34,443,tcp,tls,368721,55321,88,7992,72,63313,160,normal,-
8808171132166822931,10.0.2.15,185.125.190.49,80,tcp,http,408,1323,15,1131,15,2454,30,normal,-
-5834047253908553842,10.0.2.15,143.204.191.41,443,tcp,-,182697,214016,186,9651,121,223667,307,normal,-
-6335630889398567581,10.0.2.15,13.224.222.43,443,tcp,tls,5456,214314,172,9514,132,223828,304,normal,-
1092441048205766190,10.0.2.15,185.58.74.239,443,tcp,tls,22376,13454,28,3544,24,16998,52,normal,-
1209754731372967522,10.0.2.15,54.174.30.119,443,tcp,tls,342776,15184,46,5924,44,21108,90,normal,-
7966830553369498932,10.0.2.15,91.228.74.208,443,tcp,tls,508,9150,26,3006,24,12156,50,normal,-
-5020003629325358437,10.0.2.15,192.0.76.3,443,tcp,tls,121721,23437,59,6588,55,30025,114,normal,-
770245484958640748,10.0.2.15,52.209.67.66,443,tcp,tls,342914,16108,42,5724,42,21832,84,normal,-
681010440963730567,35.164.248.86,10.0.2.15,56910,tcp,-,0,286,4,290,4,576,8,normal,-
4915309153853896301,10.0.2.15,143.204.191.105,80,tcp,http,232004,3124,32,2578,34,5702,66,normal,-
-8526734054638237115,10.0.2.15,18.244.155.78,443,tcp,tls,231670,104742,110,6066,74,110808,184,normal,-
1412980484821371294,10.0.2.15,18.244.183.210,443,tcp,tls,340856,107206,102,5450,56,112656,158,normal,-
6171527904867091022,10.0.2.15,151.101.0.81,443,tcp,tls,134878,40274,87,9932,85,50206,172,normal,-
8309733277052017547,10.0.2.15,95.142.206.3,443,tcp,tls,193415,2572895,1918,87871,1192,2660766,3110,normal,-
-3212948678216601991,10.0.2.15,52.19.6.228,443,tcp,tls,119636,14772,42,7198,42,21970,84,normal,-
-6819649287024723163,10.0.2.15,23.195.248.145,443,tcp,tls,172734,11186,38,6782,40,17968,78,normal,-
-6961644562984628682,10.0.2.15,108.138.217.95,443,tcp,tls,2954,20074,38,4204,36,24278,74,normal,-
393927758239102002,10.0.2.15,192.0.77.48,443,tcp,tls,77731,388273,319,15532,194,403805,513,normal,-
-6049299567174563625,10.0.2.15,18.164.68.28,443,tcp,tls,61947,82226,108,12997,100,95223,208,normal,-
-6589454765615280927,10.0.2.15,52.84.93.99,443,tcp,tls,351580,593984,440,20114,322,614098,762,normal,-
7970734913326148404,10.0.2.15,147.67.210.30,443,tcp,tls,317751,93877,154,16341,129,110218,283,normal,-
7086468781950387477,10.0.2.15,18.172.155.31,443,tcp,tls,60760,100094,121,9608,90,109702,211,normal,-
-1556120111400213325,10.0.2.15,35.244.142.80,443,tcp,tls,974,26184,46,4462,40,30646,86,normal,-
-7004975383098488459,10.0.2.15,104.18.16.195,443,tcp,tls,46670,11614,32,3866,30,15480,62,normal,-
-1330932308866715932,10.0.2.15,158.101.210.189,443,tcp,tls,20848,13760,30,3504,24,17264,54,normal,-
5520254068032250589,10.0.2.15,104.76.146.21,443,tcp,tls,55832,21018,57,6442,48,27460,105,normal,-
-644652852813567451,10.0.2.15,18.165.201.108,443,tcp,tls,176380,24001,52,8116,51,32117,103,normal,-
4721779775434959361,10.0.2.15,151.101.193.164,443,tcp,tls,574,10366,24,2898,22,13264,46,normal,-
8620800332683699762,10.0.2.15,104.18.33.171,443,tcp,tls,512947,152180,148,7659,74,159839,222,normal,-
-6705439730876556877,10.0.2.15,198.54.12.180,443,tcp,tls,342624,11520,44,8072,44,19592,88,normal,-
-1412085644336819602,10.0.2.15,151.101.195.5,443,tcp,tls,9332,323181,332,24986,265,348167,597,normal,-
-8425177332008924428,10.0.2.15,18.244.179.34,443,tcp,tls,175300,48226,75,10994,74,59220,149,normal,-
6463539391346315563,10.0.2.15,35.190.43.134,443,tcp,tls,64848,25701,61,7485,61,33186,122,normal,-
-2169106111752860632,10.0.2.15,199.36.158.100,443,tcp,tls,171299,26344,60,6197,55,32541,115,normal,-
3494229077818567603,10.0.2.15,143.204.177.196,443,tcp,tls,33098,20532,60,13572,58,34104,118,normal,-
1626502197770108640,10.0.2.15,104.22.13.151,443,tcp,tls,24828,9678,30,4240,30,13918,60,normal,-
5532966246199276812,10.0.2.15,13.224.132.120,443,tcp,tls,342222,60478,74,5226,52,65704,126,normal,-
-594951247531825652,10.0.2.15,2.16.2.193,443,tcp,tls,184744,264669,245,14404,166,279073,411,normal,-
-3934855146733943381,10.0.2.15,108.156.28.58,443,tcp,tls,514167,23782,64,7133,63,30915,127,normal,-
-4432434569317289410,10.0.2.15,151.101.3.5,443,tcp,tls,171883,353680,285,12201,158,365881,443,normal,-
-6412137350848746655,10.0.2.15,52.167.30.171,443,tcp,tls,250546,36232,52,4810,38,41042,90,normal,-
22139624712566328,10.0.2.15,108.138.7.16,443,tcp,tls,47044,22096,49,6783,47,28879,96,normal,-
-8185120268625924046,10.0.2.15,34.233.137.222,443,tcp,tls,30754,9446,34,4838,32,14284,66,normal,-
4952210674883263327,10.0.2.15,151.101.2.137,443,tcp,tls,11729,81920,111,9546,86,91466,197,normal,-
-8344414367413756884,10.0.2.15,18.244.154.14,443,tcp,tls,361811,46591,71,6777,65,53368,136,normal,-
903541780862193815,10.0.2.15,192.0.72.29,443,tcp,tls,153252,17619,51,5755,46,23374,97,normal,-
8262739000817331647,10.0.2.15,13.224.223.183,443,tcp,tls,103349,153219,142,7709,78,160928,220,normal,-
8024785272142312346,10.0.2.15,151.101.193.111,443,tcp,tls,171049,25549,48,5442,48,30991,96,normal,-
1525840694908594454,10.0.2.15,2.19.126.206,443,tcp,tls,126324,72391,105,9435,73,81826,178,normal,-
4638180968143006022,10.0.2.15,205.251.242.103,443,tcp,tls,232118,15164,48,4778,48,19942,96,normal,-
-4811619471876920511,10.0.2.15,95.100.146.25,443,tcp,tls,66138,222624,213,15665,159,238289,372,normal,-
-5527553848740020894,10.0.2.15,198.143.164.252,443,tcp,tls,364591,651798,537,30249,411,682047,948,normal,-
1223940351424114967,10.0.2.15,2.16.2.88,443,tcp,tls,131141,36737,67,5565,53,42302,120,normal,-
-207332955788903192,10.0.2.15,151.101.67.5,443,tcp,tls,412,14036,28,3136,28,17172,56,normal,-
-4239402293117791611,10.0.2.15,52.21.62.149,443,tcp,tls,72379,20756,44,5554,44,26310,88,normal,-
-3088687922526339655,10.0.2.15,162.247.243.30,443,tcp,tls,174177,15641,54,15453,57,31094,111,normal,-
4113205367357169800,10.0.2.15,18.165.201.79,443,tcp,tls,341498,84672,86,5124,50,89796,136,normal,-
-8181201346703827487,10.0.2.15,146.75.118.132,443,tcp,tls,44682,36960,50,7078,36,44038,86,normal,-
-5162607772201462591,10.0.2.15,44.207.130.4,443,tcp,tls,30044,13376,30,5898,30,19274,60,normal,-
-5486513925447655149,10.0.2.15,151.101.194.152,443,tcp,tls,172081,70442,112,10675,95,81117,207,normal,-
6574193361907120444,10.0.2.15,18.210.88.25,443,tcp,tls,344460,18948,62,7094,62,26042,124,normal,-
2614519579140420283,10.0.2.15,217.20.147.1,443,tcp,tls,208666,25436,44,4732,44,30168,88,normal,-
3727813409667143739,10.0.2.15,13.224.247.127,443,tcp,tls,242798,20292,46,4684,42,24976,88,normal,-
1689717563582926941,10.0.2.15,52.94.225.56,443,tcp,tls,268164,62158,195,127244,200,189402,395,normal,-
3435107209995212876,10.0.2.15,23.195.248.158,443,tcp,tls,272862,297367,275,15846,184,313213,459,normal,-
741169146728388338,10.0.2.15,146.75.118.109,443,tcp,tls,131978,1386236,1054,39343,556,1425579,1610,normal,-
-4842897493645261880,10.0.2.15,104.16.100.56,443,tcp,tls,62816,13372,36,4444,38,17816,74,normal,-
-5316347319162455166,10.0.2.15,13.224.132.12,443,tcp,tls,385680,50818,76,6692,62,57510,138,normal,-
7706896990970154628,10.0.2.15,87.248.100.215,443,tcp,tls,243648,50958,64,5330,54,56288,118,normal,-
-220511387203134564,10.0.2.15,54.192.137.50,443,tcp,tls,342687,20146,49,5106,48,25252,97,normal,-
6287276980560374127,10.0.2.15,99.84.9.105,443,tcp,tls,38338,17964,36,4388,36,22352,72,normal,-
-1241513426408982396,10.0.2.15,54.192.137.106,443,tcp,tls,10364,174406,142,6342,76,180748,218,normal,-
-8871562550975997639,10.0.2.15,52.222.214.101,443,tcp,tls,185853,23650,56,6791,55,30441,111,normal,-
-3374772147815030869,10.0.2.15,108.138.8.107,443,tcp,tls,274799,2828692,2081,70521,932,2899213,3013,normal,-
7076880530668875017,10.0.2.15,143.204.72.186,443,tcp,tls,332784,31414,52,4902,46,36316,98,normal,-
-1599698111354274750,10.0.2.15,91.198.174.192,443,tcp,tls,318375,51712,117,13206,108,64918,225,normal,-
-3667799972411522885,10.0.2.15,186.192.90.12,443,tcp,tls,167126,31694,81,9235,82,40929,163,normal,-
-7189946110105131576,10.0.2.15,193.189.143.34,443,tcp,tls,110272,39620,58,6111,59,45731,117,normal,-
1859159199683427867,10.0.2.15,99.84.9.60,443,tcp,tls,263042,651508,505,20679,288,672187,793,normal,-
7507159870997047930,10.0.2.15,18.165.242.59,443,tcp,tls,12476,447842,362,16126,212,463968,574,normal,-
-6470450411080933782,10.0.2.15,18.244.155.8,443,tcp,tls,421050,16728038,11678,221228,2768,16949266,14446,normal,-
-8941797723467716283,10.0.2.15,207.241.224.2,443,tcp,tls,242915,40670,67,6959,61,47629,128,normal,-
-1518610251386919250,10.0.2.15,104.18.23.19,443,tcp,tls,171595,17514,50,6303,50,23817,100,normal,-
1351302238719998209,10.0.2.15,108.156.46.12,443,tcp,tls,34654,30262,52,9470,48,39732,100,normal,-
9216795802270642516,10.0.2.15,87.240.132.67,443,tcp,tls,140190,349066,299,23418,256,372484,555,normal,-
-4204463110843182171,10.0.2.15,104.16.53.111,443,tcp,tls,257276,60813,89,8222,82,69035,171,normal,-
-9210478620873383672,10.0.2.15,18.165.242.4,443,tcp,tls,151424,37141,81,10425,77,47566,158,normal,-
-2100462828435739671,10.0.2.15,185.89.210.153,443,tcp,tls,564,8858,20,3264,20,12122,40,normal,-
-3442641621183482424,10.0.2.15,108.138.233.117,443,tcp,tls,45744,18612,38,4420,36,23032,74,normal,-
-7284680888039595758,10.0.2.15,185.83.142.19,443,tcp,tls,37920,23848,70,44976,66,68824,136,normal,-
4028454967984967349,10.0.2.15,5.57.16.220,443,tcp,tls,67482,18894,60,12468,61,31362,121,normal,-
-2295533840975423185,10.0.2.15,172.64.154.85,443,tcp,tls,342740,43460,68,6480,68,49940,136,normal,-
1019239831517999063,10.0.2.15,104.87.135.46,443,tcp,tls,59136,24354,34,3926,32,28280,66,normal,-
-494879909992967973,10.0.2.15,108.138.217.78,443,tcp,tls,511225,26207,66,7391,63,33598,129,normal,-
462740232107456483,10.0.2.15,104.96.130.36,443,tcp,tls,292097,151915,180,15850,165,167765,345,normal,-
-4630304178208988204,10.0.2.15,52.94.228.167,443,tcp,tls,287605,23652,65,6698,64,30350,129,normal,-
2389861263543575817,10.0.2.15,157.240.20.52,443,tcp,tls,172055,20180,62,6493,61,26673,123,normal,-
424266992249811059,10.0.2.15,87.240.129.132,443,tcp,tls,216627,20375,65,9920,60,30295,125,normal,-
-283032194233671232,10.0.2.15,18.244.123.195,443,tcp,tls,60064,19142,40,4202,36,23344,76,normal,-
7073915406855858418,10.0.2.15,149.154.167.99,443,tcp,tls,600456,2538963,1974,56720,800,2595683,2774,normal,-
-1109675737229577228,10.0.2.15,104.19.187.97,443,tcp,tls,590636,187629,262,20938,196,208567,458,normal,-
2438544915403874925,10.0.2.15,216.198.2.50,443,tcp,tls,182594,12434,42,4384,42,16818,84,normal,-
4992786990507453860,10.0.2.15,3.219.0.3,443,tcp,tls,127082,14820,42,6370,44,21190,86,normal,-
-1356894878003407444,10.0.2.15,143.204.89.104,443,tcp,tls,45744,30384,46,4304,36,34688,82,normal,-
2512430793072733774,10.0.2.15,162.125.248.18,443,tcp,tls,146919,14735,49,6049,45,20784,94,normal,-
-6464966889977118306,10.0.2.15,18.66.112.50,443,tcp,tls,341006,16116,42,4756,42,20872,84,normal,-
4558857311754135,10.0.2.15,151.101.193.44,443,tcp,tls,204892,479439,471,44121,376,523560,847,normal,-
7857582663407822111,10.0.2.15,13.224.132.111,443,tcp,tls,342152,295250,236,9288,126,304538,362,normal,-
-7406873103749690263,10.0.2.15,104.17.204.204,443,tcp,tls,342960,11230,38,4594,38,15824,76,normal,-
-4868260392101207761,10.0.2.15,200.147.3.157,443,tcp,tls,128096,13572,43,5647,45,19219,88,normal,-
-490529876900459352,10.0.2.15,2.16.2.211,443,tcp,tls,232450,12650,50,4768,46,17418,96,normal,-
-176638485765575004,10.0.2.15,18.244.159.213,443,tcp,tls,1409,27149,67,8488,67,35637,134,normal,-
-3566732530276263563,10.0.2.15,142.251.36.141,443,tcp,tls,419069,594830,484,23087,286,617917,770,normal,-
4915064090209879370,10.0.2.15,18.172.155.156,443,tcp,tls,101514,257686,204,10992,154,268678,358,normal,-
7991603919821892301,10.0.2.15,23.195.249.96,443,tcp,tls,49228,103327,118,8155,72,111482,190,normal,-
-4001771174854745837,10.0.2.15,54.154.181.12,443,tcp,tls,86386,12994,38,4966,38,17960,76,normal,-
2982349532527701795,10.0.2.15,99.86.114.18,443,tcp,tls,342476,73926,80,5310,52,79236,132,normal,-
5984617367594954392,10.0.2.15,104.244.42.136,443,tcp,tls,101312,43880,58,8452,60,52332,118,normal,-
-3109808312615878148,10.0.2.15,18.197.207.161,443,tcp,tls,357522,20228,70,21230,72,41458,142,normal,-
-6758949720476503543,10.0.2.15,18.244.114.111,443,tcp,tls,342450,21394,50,6762,46,28156,96,normal,-
6461741130172210553,10.0.2.15,23.195.248.195,443,tcp,tls,230922,47896,72,5244,52,53140,124,normal,-
-8180879968636237517,10.0.2.15,18.165.201.46,443,tcp,tls,284,6536,12,1722,12,8258,24,normal,-
5245834005188668623,10.0.2.15,104.17.113.188,443,tcp,tls,501783,25005,76,8520,70,33525,146,normal,-
1646513075783869484,10.0.2.15,162.159.138.60,443,tcp,tls,376717,98120,141,14695,108,112815,249,normal,-
4616166183499797899,10.0.2.15,64.202.112.223,443,tcp,tls,23203,13471,39,5643,39,19114,78,normal,-
2684166211693606342,10.0.2.15,104.64.118.15,443,tcp,tls,86152,22600,38,3996,30,26596,68,normal,-
-4978639162834823641,10.0.2.15,172.67.4.41,443,tcp,tls,116240,18614,44,5257,44,23871,88,normal,-
-8342399777620714174,10.0.2.15,99.86.4.88,443,tcp,tls,578437,59983,107,13864,100,73847,207,normal,-
3923257619935473792,10.0.2.15,13.107.238.44,443,tcp,tls,865308,350867,338,20192,187,371059,525,normal,-
-7002772009206094884,10.0.2.15,95.100.146.16,443,tcp,tls,277991,127121,128,9925,97,137046,225,normal,-
4072937957068179247,10.0.2.15,23.73.141.183,443,tcp,tls,51724,463690,417,31304,362,494994,779,normal,-
-1144784355295171394,10.0.2.15,99.83.181.31,443,tcp,tls,16530,20931,58,13358,59,34289,117,normal,-
-234310828601712208,10.0.2.15,151.101.193.67,443,tcp,tls,41056,73990,84,8074,56,82064,140,normal,-
-8484454186737852356,10.0.2.15,13.224.222.106,443,tcp,tls,28970,200314,160,7150,90,207464,250,normal,-
3409739959121970492,10.0.2.15,192.229.221.185,443,tcp,tls,340788,32604,60,5242,50,37846,110,normal,-
-2145737268048118600,10.0.2.15,151.101.194.133,443,tcp,tls,141961,29262,69,8876,64,38138,133,normal,-
2455497483062502964,10.0.2.15,162.159.153.4,443,tcp,tls,172154,15494,47,5625,45,21119,92,normal,-
4556707021672899880,10.0.2.15,151.101.66.152,443,tcp,tls,4532,13076,30,3872,30,16948,60,normal,-
-676546201095013468,10.0.2.15,104.18.22.19,443,tcp,tls,494,7996,20,2704,20,10700,40,normal,-
7227615352800055270,10.0.2.15,186.192.81.5,443,tcp,tls,102976,18243,41,5162,43,23405,84,normal,-
2446270272105978681,10.0.2.15,104.17.67.176,443,tcp,tls,387918,97642,102,7674,94,105316,196,normal,-
1031900104934958793,10.0.2.15,52.213.145.217,443,tcp,tls,175148,12468,42,5868,40,18336,82,normal,-
4147329690160719065,10.0.2.15,151.101.1.164,443,tcp,tls,206402,17336,46,4732,38,22068,84,normal,-
-7011106593398698975,10.0.2.15,151.101.192.176,443,tcp,tls,631976,319785,310,16496,191,336281,501,normal,-
4447539512920380858,10.0.2.15,52.17.134.160,443,tcp,tls,118000,13922,36,4684,38,18606,74,normal,-
5198552313173686842,10.0.2.15,104.20.150.16,443,tcp,tls,225400,12940,36,4178,34,17118,70,normal,-
6630794249495089475,10.0.2.15,20.112.52.29,443,tcp,tls,345770,19198,46,4896,46,24094,92,normal,-
6531086993231090013,10.0.2.15,18.66.97.53,443,tcp,tls,124552,28362,48,4700,44,33062,92,normal,-
-8310783913371582763,10.0.2.15,18.244.155.113,443,tcp,tls,290596,17062,46,4900,46,21962,92,normal,-
4591688634844128977,10.0.2.15,151.101.1.55,443,tcp,tls,902,323802,250,8786,118,332588,368,normal,-
5818108516347956448,10.0.2.15,52.215.192.131,443,tcp,tls,254580,85278,92,6080,66,91358,158,normal,-
-8262969113291339481,10.0.2.15,151.101.193.21,443,tcp,tls,510320,74653,113,13391,101,88044,214,normal,-
5754209926123615967,10.0.2.15,104.18.2.186,443,tcp,tls,994,44148,54,4562,38,48710,92,normal,-
-1053721386280284363,10.0.2.15,54.159.56.141,443,tcp,tls,124338,14524,42,4786,40,19310,82,normal,-
-1769614407569965344,10.0.2.15,95.142.206.1,443,tcp,tls,256755,138964,160,13813,132,152777,292,normal,-
-8970889101626357813,10.0.2.15,34.247.198.11,443,tcp,tls,74194,17966,38,4134,36,22100,74,normal,-
-4282533856047563103,10.0.2.15,108.156.46.65,443,tcp,tls,37438,15090,36,5368,34,20458,70,normal,-
-4705950281642324443,10.0.2.15,54.205.105.217,443,tcp,tls,91871,27269,63,9583,63,36852,126,normal,-
7307373463251954183,10.0.2.15,195.214.233.128,443,tcp,tls,11028,14786,30,3804,30,18590,60,normal,-
-7928341588135768417,10.0.2.15,3.33.220.150,443,tcp,tls,362301,22821,59,11083,63,33904,122,normal,-
-3414571548394002660,10.0.2.15,40.126.31.67,443,tcp,tls,231286,24704,54,5276,48,29980,102,normal,-
-3820849042267409368,10.0.2.15,167.68.44.27,443,tcp,tls,4604,18678,28,3700,28,22378,56,normal,-
4684021927650785656,10.0.2.15,18.165.229.164,443,tcp,tls,46852,106542,98,5062,52,111604,150,normal,-
7272899311677378929,10.0.2.15,95.100.146.80,443,tcp,tls,23029,50931,85,8714,70,59645,155,normal,-
7795838014930447225,10.0.2.15,104.18.3.236,443,tcp,tls,65218,60772,64,4526,42,65298,106,normal,-
-665284579103300406,10.0.2.15,52.95.122.74,443,tcp,tls,64882,25819,50,8537,51,34356,101,normal,-
8434962144372524557,10.0.2.15,104.19.147.8,443,tcp,tls,187389,78721,95,7338,65,86059,160,normal,-
-8630360381757322349,10.0.2.15,104.17.112.176,443,tcp,tls,341986,16568,44,4556,40,21124,84,normal,-
8797779967998499115,10.0.2.15,162.125.72.18,443,tcp,tls,146739,28272,66,6547,54,34819,120,normal,-
-3165594219218866174,10.0.2.15,34.238.65.140,443,tcp,tls,343212,16798,50,9418,48,26216,98,normal,-
-7899514663980668224,10.0.2.15,185.26.182.103,443,tcp,tls,86624,9052,28,3652,30,12704,58,normal,-
-5022300671642140276,10.0.2.15,108.138.233.18,443,tcp,tls,343198,36882,56,4880,46,41762,102,normal,-
-7315499598772403520,10.0.2.15,194.226.130.227,443,tcp,tls,69189,20093,50,6045,52,26138,102,normal,-
2944158091137128625,10.0.2.15,3.126.37.214,443,tcp,tls,341050,13456,52,10266,52,23722,104,normal,-
5631480316162516261,10.0.2.15,74.115.50.110,443,tcp,tls,33942,27742,50,5667,44,33409,94,normal,-
-496248727102861012,10.0.2.15,204.79.197.212,443,tcp,tls,226290,11698,36,4544,36,16242,72,normal,-
2409739706009183033,10.0.2.15,108.156.28.93,443,tcp,tls,121456,15514,38,4434,38,19948,76,normal,-
1292422113468598638,10.0.2.15,18.244.155.16,443,tcp,tls,13660,11162,22,2694,26,13856,48,normal,-
2994276250687546362,10.0.2.15,151.101.1.111,443,tcp,tls,244096,26718,56,5540,54,32258,110,normal,-
-4613693828937510051,10.0.2.15,95.142.206.0,443,tcp,tls,256966,86320,110,9714,90,96034,200,normal,-
9012298629635793454,10.0.2.15,52.35.165.153,443,tcp,tls,57390,20594,92,30936,78,51530,170,normal,-
6167609636394856056,10.0.2.15,34.252.19.64,443,tcp,tls,576,12518,20,2514,22,15032,42,normal,-
9032086491296573630,10.0.2.15,2.16.2.194,443,tcp,tls,241444,19954,48,4894,40,24848,88,normal,-
208614501861529570,10.0.2.15,44.205.203.243,443,tcp,tls,357958,25582,84,27540,76,53122,160,normal,-
-4486610934818169603,10.0.2.15,52.28.145.129,443,tcp,tls,357452,17906,80,22380,80,40286,160,normal,-
4486452602060753897,10.0.2.15,151.101.194.2,443,tcp,tls,255725,20314,55,6425,51,26739,106,normal,-
6439809405028984616,10.0.2.15,147.92.243.206,443,tcp,tls,80385,34716,70,7786,71,42502,141,normal,-
-8248431312219230624,10.0.2.15,3.221.54.232,443,tcp,tls,345380,16982,54,7096,54,24078,108,normal,-
-5012337001209359404,10.0.2.15,3.70.113.20,443,tcp,tls,70010,24454,53,6267,52,30721,105,normal,-
-7490156139859994299,10.0.2.15,147.67.34.45,443,tcp,tls,231948,10760,48,4732,50,15492,98,normal,-
1585077059997910430,10.0.2.15,75.2.13.80,443,tcp,tls,40298,34476,93,14654,95,49130,188,normal,-
-988876664833844356,10.0.2.15,108.156.46.35,443,tcp,tls,31744,14018,28,3242,28,17260,56,normal,-
5913315995036718865,10.0.2.15,207.148.248.132,443,tcp,tls,121277,75400,98,10063,95,85463,193,normal,-
2847876532630672191,10.0.2.15,151.101.193.55,443,tcp,tls,59640,185870,164,9019,102,194889,266,normal,-
782055474968711185,10.0.2.15,52.28.225.104,443,tcp,tls,400734,20548,84,13280,86,33828,170,normal,-
-652977621143635719,10.0.2.15,52.208.79.137,443,tcp,tls,744,12452,24,3850,24,16302,48,normal,-
5818818447215569278,10.0.2.15,13.224.245.45,443,tcp,tls,1086,45768,56,6550,44,52318,100,normal,-
-1821355605177566396,10.0.2.15,156.40.212.210,443,tcp,tls,339003,22965,73,7374,76,30339,149,normal,-
-4506942771362899235,10.0.2.15,35.165.157.22,443,tcp,tls,1888,9060,28,3006,24,12066,52,normal,-
-8094401774808378560,10.0.2.15,70.42.32.63,443,tcp,tls,22791,13896,39,7110,36,21006,75,normal,-
7673380259819965403,10.0.2.15,54.204.7.191,443,tcp,tls,384688,20589,65,8795,68,29384,133,normal,-
-1140301605587059226,10.0.2.15,45.60.243.32,443,tcp,tls,345980,306298,292,16650,200,322948,492,normal,-
3720766500349624560,10.0.2.15,52.95.116.112,443,tcp,tls,61030,14716,30,3804,30,18520,60,normal,-
3788297273803461457,10.0.2.15,188.65.124.92,443,tcp,tls,92156,17996,45,5570,45,23566,90,normal,-
-1509218250747317054,10.0.2.15,13.224.245.3,443,tcp,tls,172281,2115031,1478,63793,1106,2178824,2584,normal,-
5244091176134348295,10.0.2.15,40.79.197.35,443,tcp,tls,360357,37250,119,48718,121,85968,240,normal,-
7905174753176478133,10.0.2.15,192.0.80.240,443,tcp,tls,61350,13796,34,3768,28,17564,62,normal,-
-4970776316553499671,10.0.2.15,104.17.211.204,443,tcp,tls,384842,16182,52,6066,52,22248,104,normal,-
-9200644427784533385,10.0.2.15,13.32.27.99,443,tcp,tls,40782,17234,36,4476,36,21710,72,normal,-
2649493217620906250,10.0.2.15,212.53.152.212,443,tcp,tls,343376,39862,64,6546,62,46408,126,normal,-
-8316124349171091026,10.0.2.15,13.224.222.80,443,tcp,tls,124342,57368,68,6258,64,63626,132,normal,-
8898507794568463980,10.0.2.15,52.1.171.248,443,tcp,tls,402578,11682,52,7506,54,19188,106,normal,-
1257245509768353711,10.0.2.15,87.240.132.72,443,tcp,tls,291970,22590,44,4704,42,27294,86,normal,-
-2307802772440223236,10.0.2.15,95.100.146.40,443,tcp,tls,583358,279709,337,19638,230,299347,567,normal,-
3971309671654681640,10.0.2.15,204.79.197.203,443,tcp,tls,455603,150017,177,17344,125,167361,302,normal,-
-1707780557833295705,10.0.2.15,151.101.130.216,443,tcp,tls,347394,3010266,2274,83434,1140,3093700,3414,normal,-
-1921631911596124958,10.0.2.15,52.51.192.217,443,tcp,tls,120606,15116,44,5040,42,20156,86,normal,-
-1628998834553833530,10.0.2.15,52.98.171.226,443,tcp,tls,1326,35302,48,4406,38,39708,86,normal,-
4399420968555505733,10.0.2.15,104.17.233.204,443,tcp,tls,621414,580966,512,29901,426,610867,938,normal,-
-2083933462375376861,10.0.2.15,104.64.164.240,443,tcp,tls,232080,52092,76,5072,54,57164,130,normal,-
4228432933158251497,10.0.2.15,18.244.114.71,443,tcp,tls,342060,16314,42,4810,42,21124,84,normal,-
1485527004877475100,10.0.2.15,192.229.221.25,443,tcp,tls,635833,834839,745,47377,533,882216,1278,normal,-
-6860283874039890370,10.0.2.15,104.17.214.204,443,tcp,tls,341166,11126,38,4456,38,15582,76,normal,-
-273360741138720073,10.0.2.15,52.73.253.114,443,tcp,tls,109920,35632,196,65018,176,100650,372,normal,-
2354965287358240474,10.0.2.15,18.244.155.97,443,tcp,tls,47834,39570,48,4450,40,44020,88,normal,-
-3235043903266503222,10.0.2.15,34.243.115.23,443,tcp,tls,342098,11356,44,6822,42,18178,86,normal,-
7475161767657088760,10.0.2.15,34.150.242.72,443,tcp,tls,6306,82302,74,4564,44,86866,118,normal,-
5714863673884563455,10.0.2.15,104.18.21.157,443,tcp,tls,254660,9564,38,6258,38,15822,76,normal,-
6336039447821472067,10.0.2.15,146.75.120.157,443,tcp,tls,295768,530010,456,24743,323,554753,779,normal,-
6834941965608076080,10.0.2.15,151.101.194.110,443,tcp,tls,388391,149988,160,10391,110,160379,270,normal,-
-7751257601469970177,10.0.2.15,172.64.132.15,443,tcp,tls,3450,265724,210,12198,172,277922,382,normal,-
7956975488135646897,10.0.2.15,104.26.7.139,443,tcp,tls,341884,35610,52,4596,40,40206,92,normal,-
-4589172213570307890,10.0.2.15,52.94.237.74,443,tcp,tls,124396,15404,38,5354,38,20758,76,normal,-
1991646362480678971,10.0.2.15,143.204.207.250,443,tcp,tls,126484,43612,60,4792,46,48404,106,normal,-
-7731301273330918063,10.0.2.15,151.101.2.132,443,tcp,tls,344298,2236314,1616,52086,816,2288400,2432,normal,-
-3085401015086536068,10.0.2.15,34.193.254.183,443,tcp,tls,343496,14576,44,4918,42,19494,86,normal,-
-5204648571819386635,10.0.2.15,108.156.29.170,443,tcp,tls,499608,67614,134,47422,126,115036,260,normal,-
702775047205166934,10.0.2.15,52.84.93.28,443,tcp,tls,342608,99390,100,5816,62,105206,162,normal,-
-5695212146256772421,10.0.2.15,18.165.201.38,443,tcp,tls,120142,42108,56,4920,48,47028,104,normal,-
2752625459152802884,10.0.2.15,99.86.4.49,443,tcp,tls,70852,22940,40,4314,38,27254,78,normal,-
2039257039879116052,10.0.2.15,34.254.167.94,443,tcp,tls,118402,14758,38,5258,40,20016,78,normal,-
-4564010766245479002,10.0.2.15,108.138.217.21,443,tcp,tls,33064,16638,32,4504,32,21142,64,normal,-
429773644930728146,10.0.2.15,54.188.165.239,443,tcp,tls,86126,24640,114,40242,104,64882,218,normal,-
6067945831375455814,10.0.2.15,192.0.72.2,443,tcp,tls,120426,11950,40,4288,36,16238,76,normal,-
-8902830534225713055,10.0.2.15,104.96.145.246,443,tcp,tls,240550,262680,220,8936,120,271616,340,normal,-
5316282262506681515,10.0.2.15,142.251.36.102,443,tcp,tls,3438,42365,108,13517,99,55882,207,normal,-
-336192131235281801,10.0.2.15,18.244.179.62,443,tcp,tls,349044,442434,356,15398,206,457832,562,normal,-
-1716595459351023300,10.0.2.15,23.227.38.33,443,tcp,tls,171796,21146,51,5951,51,27097,102,normal,-
-8710925961879855138,10.0.2.15,108.156.46.93,443,tcp,tls,342774,348318,274,14828,222,363146,496,normal,-
-6675429815912201030,10.0.2.15,216.69.141.26,443,tcp,tls,62070,11536,34,4232,36,15768,70,normal,-
-884735847835888696,10.0.2.15,35.244.193.51,443,tcp,tls,1550,13374,36,4508,38,17882,74,normal,-
-7817859282150304630,10.0.2.15,143.204.68.101,443,tcp,tls,341178,34428,58,5172,50,39600,108,normal,-
-1624934777191863784,10.0.2.15,18.66.97.30,443,tcp,tls,342098,17586,44,4702,42,22288,86,normal,-
8483107604136883352,10.0.2.15,2.16.2.208,443,tcp,tls,47504,50934,54,4270,36,55204,90,normal,-
1697585649674522854,10.0.2.15,204.79.197.219,443,tcp,tls,204000,15912,42,4866,42,20778,84,normal,-
7058423259355661425,10.0.2.15,172.64.144.78,443,tcp,tls,82106,20332,58,16626,58,36958,116,normal,-
7351711644213083586,10.0.2.15,178.250.0.162,443,tcp,tls,30874,14959,51,6540,49,21499,100,normal,-
7448242388444350319,10.0.2.15,13.224.245.42,443,tcp,tls,330,6536,12,1722,12,8258,24,normal,-
-8357269620024592123,10.0.2.15,192.0.78.25,443,tcp,tls,68832,11456,34,3868,30,15324,64,normal,-
3654327424358268913,10.0.2.15,104.17.49.95,443,udp,-,397224,2935450,3924,2077528,2898,5012978,6822,normal,-
-5618653869773400421,10.0.2.15,23.195.248.208,443,tcp,tls,242684,161141,158,12635,95,173776,253,normal,-
8855707349789112337,10.0.2.15,104.19.154.83,443,udp,-,74588,29151,59,10702,33,39853,92,normal,-
-7534604622323816128,10.0.2.15,13.224.192.222,80,tcp,http,337452,18428,67,10335,70,28763,137,normal,-
4732476675401494045,10.0.2.15,130.211.23.194,443,udp,-,575,17996,21,5702,18,23698,39,normal,-
8735642814366488952,10.0.2.15,195.8.215.136,443,tcp,tls,23456,15400,32,3804,32,19204,64,normal,-
248250771673666038,10.0.2.15,151.101.195.5,443,udp,-,2247,66729,63,23750,73,90479,136,normal,-
-842344558172151564,10.0.2.15,104.17.50.95,443,udp,-,76716,177557,263,83793,249,261350,512,normal,-
7831864320877576662,10.0.2.15,151.101.0.81,443,udp,-,19355,242022,195,22907,83,264929,278,normal,-
-2279057648467947539,10.0.2.15,108.156.46.47,443,udp,-,350,15778,18,4404,18,20182,36,normal,-
7276887349606804179,10.0.2.15,99.84.9.96,443,udp,-,10140,863598,598,29214,200,892812,798,normal,-
1847634847462363277,10.0.2.15,142.251.37.102,443,udp,-,6578,67752,68,9113,36,76865,104,normal,-
275774590551613732,10.0.2.15,157.240.30.54,443,udp,-,41137,2251998,1818,82084,750,2334082,2568,normal,-
-8289551160781240225,10.0.2.15,192.0.78.9,443,tcp,tls,150668,11954,38,4604,42,16558,80,normal,-
6252025050854614617,10.0.2.15,151.101.1.55,443,udp,-,3838,9498,14,4808,16,14306,30,normal,-
-256005867722869648,10.0.2.15,198.54.117.250,443,tcp,tls,31548,13816,36,4112,32,17928,68,normal,-
1420934975639917886,10.0.2.15,92.123.239.50,443,tcp,tls,40564,10894,36,4012,32,14906,68,normal,-
7838822406114058939,10.0.2.15,35.164.248.86,443,tcp,-,426,832,12,672,10,1504,22,normal,-
-8144590695139904014,10.0.2.15,35.201.125.192,443,udp,-,818,14288,16,4452,18,18740,34,normal,-
6976618678517167155,10.0.2.15,142.251.36.102,443,udp,-,5937,44425,52,13022,50,57447,102,normal,-
5535421338463844892,10.0.2.15,142.251.36.105,443,udp,-,625,21043,24,5860,20,26903,44,normal,-
1510575517422658676,10.0.2.15,104.18.215.59,443,udp,-,248,11430,12,4230,14,15660,26,normal,-
-6733128105356167284,10.0.2.15,104.18.34.10,443,udp,-,616,14626,22,3850,12,18476,34,normal,-
-1182984859648303708,10.0.2.15,52.222.229.186,443,udp,-,20136,1324040,949,48627,353,1372667,1302,normal,-
7626498040547448100,10.0.2.15,143.204.89.60,80,tcp,http,233922,3032,32,2564,34,5596,66,normal,-
6658539308145729105,10.0.2.15,104.18.11.207,443,udp,-,58360,200880,183,9963,53,210843,236,normal,-
-4229791063612974745,10.0.2.15,34.160.46.1,443,udp,-,452,10436,14,3510,8,13946,22,normal,-
6631294889372076848,10.0.2.15,151.101.192.81,443,udp,-,10124,36478,39,12778,43,49256,82,normal,-
-3826177509437169509,10.0.2.15,151.101.194.152,443,udp,-,923,46056,44,10602,33,56658,77,normal,-
8891536749641717863,10.0.2.15,216.239.36.54,443,udp,-,650,44045,41,7189,34,51234,75,normal,-
775600568174596944,10.0.2.15,35.244.193.51,443,udp,-,532,12010,14,3804,12,15814,26,normal,-
1453003460221582448,10.0.2.15,151.101.67.5,443,udp,-,602,21365,19,8083,23,29448,42,normal,-
7515475958692947639,10.0.2.15,104.16.133.229,443,udp,-,306,13308,22,4040,14,17348,36,normal,-
-6090921185459484537,10.0.2.15,172.64.132.15,443,udp,-,694,15740,27,5685,17,21425,44,normal,-
-2195301364858976418,10.0.2.15,34.211.24.183,443,tcp,tls,199144,49910,258,104596,254,154506,512,normal,-
4115833899072988604,10.0.2.15,162.159.153.4,443,udp,-,501,17081,32,6287,21,23368,53,normal,-
104216304610272315,10.0.2.15,35.244.142.80,443,udp,-,366,11968,14,3800,12,15768,26,normal,-
-1906396114265777923,10.0.2.15,142.251.36.141,443,udp,-,1859,46378,74,19825,67,66203,141,normal,-
15169130087324400,10.0.2.15,64.4.250.36,443,tcp,tls,91017,15768,47,5890,44,21658,91,normal,-
1506527563463433360,10.0.2.15,104.18.214.59,443,udp,-,1462,183020,168,8872,46,191892,214,normal,-
-6010657994316854869,10.0.2.15,151.101.1.195,443,udp,-,404,15974,14,4116,14,20090,28,normal,-
-1927909944893854787,10.0.2.15,141.193.213.30,443,udp,-,61030,345262,348,82134,168,427396,516,normal,-
-4675294473388081941,10.0.2.15,13.224.222.43,443,udp,-,19510,140778,110,10234,48,151012,158,normal,-
233879999663786466,10.0.2.15,104.19.155.83,443,udp,-,387332,106338,202,54143,159,160481,361,normal,-
8123875807356801203,10.0.2.15,35.190.43.134,443,udp,-,534,13446,20,5414,20,18860,40,normal,-
-7409147058087310432,10.0.2.15,18.165.242.56,443,udp,-,382,15778,18,4194,16,19972,34,normal,-
-7864538229207303172,10.0.2.15,34.120.133.55,443,udp,-,4730,22999,28,7965,22,30964,50,normal,-
1483697930244910636,10.0.2.15,18.244.159.213,443,udp,-,3806,18288,26,6434,24,24722,50,normal,-
-5746536687739204623,10.0.2.15,104.17.204.204,443,udp,-,340,12942,20,3662,10,16604,30,normal,-
983790214915472172,10.0.2.15,104.18.22.19,443,udp,-,334,10546,18,4690,18,15236,36,normal,-
1153073649252846097,10.0.2.15,204.79.197.203,80,tcp,http,131238,5838,22,2098,22,7936,44,normal,-
-508769695742374992,10.0.2.15,199.36.158.100,443,udp,-,679,22993,23,6768,23,29761,46,normal,-
-2635495225172939380,10.0.2.15,207.148.248.132,80,tcp,http,20808,794,10,1230,12,2024,22,normal,-
-4940261048027259628,10.0.2.15,18.192.227.72,443,tcp,tls,61682,9036,36,4288,34,13324,70,normal,-
6565514396434104748,10.0.2.15,23.195.248.184,80,tcp,-,126550,1732,22,1761,25,3493,47,normal,-
-3447271473475140333,10.0.2.15,34.95.69.49,443,udp,-,590,17994,21,5704,18,23698,39,normal,-
141726164623566390,10.0.2.15,104.18.23.19,443,udp,-,527,20074,33,6073,19,26147,52,normal,-
510631978993222297,10.0.2.15,34.96.112.9,443,udp,-,354,12886,16,3966,14,16852,30,normal,-
-56259043340537660,10.0.2.15,23.227.38.33,443,udp,-,819,27480,40,6882,28,34362,68,normal,-
-5777009343722789499,10.0.2.15,104.16.124.96,443,udp,-,370,10478,18,3854,12,14332,30,normal,-
4050197679554061457,10.0.2.15,157.240.20.52,443,udp,-,545,19201,29,6115,20,25316,49,normal,-
-2537816339993698994,10.0.2.15,151.101.193.55,443,udp,-,15267,733315,669,65205,229,798520,898,normal,-
7414546342134101607,10.0.2.15,104.18.2.186,443,udp,-,7712,87078,132,103724,122,190802,254,normal,-
3282956866368799162,10.0.2.15,34.110.253.203,443,udp,-,2131,18356,31,8675,27,27031,58,normal,-
-2770309653384964907,10.0.2.15,151.101.194.49,443,udp,-,37816,0,0,36374,26,36374,26,normal,-
7479154863226054918,10.0.2.15,13.224.245.45,443,udp,-,412,12954,18,3996,14,16950,32,normal,-
-2772098153306803770,10.0.2.15,151.101.3.5,443,udp,-,12888,3258779,2404,122538,644,3381317,3048,normal,-
31337581456652110,10.0.2.15,52.98.171.226,443,udp,-,1294,26594,22,7002,18,33596,40,normal,-
-443493422500253835,10.0.2.15,34.102.232.32,443,udp,-,460,12020,14,3966,14,15986,28,normal,-
1022651663518039661,10.0.2.15,104.18.24.185,443,udp,-,18013,25471,53,40982,53,66453,106,normal,-
8724028981495704048,10.0.2.15,91.189.91.157,123,udp,ntp,1015,540,6,540,6,1080,12,normal,-
-6410882004066230759,10.0.2.15,142.251.36.81,443,tcp,tls,5683,22426,55,11872,56,34298,111,normal,-
-3633044425744675354,10.0.2.15,65.9.94.208,443,tcp,tls,30352,34420,66,7403,77,41823,143,normal,-
3319260599114138852,10.0.2.15,216.239.36.178,443,tcp,tls,171346,24357,55,6349,55,30706,110,normal,-
-6809746016743873364,10.0.2.15,142.250.27.156,443,tcp,tls,171229,23934,55,6349,55,30283,110,normal,-
7286437865179637701,10.0.2.15,151.101.129.184,443,udp,-,37834,0,0,36374,26,36374,26,normal,-
3673196480350405105,10.0.2.15,44.235.246.155,443,tcp,tls,151772,12886,38,4416,38,17302,76,normal,-
3590324306298048661,10.0.2.15,185.26.182.104,443,tcp,-,98,120,2,256,4,376,6,normal,-
2881998847561636813,10.0.2.15,200.147.35.149,443,tcp,tls,129702,13572,43,5647,45,19219,88,normal,-
628575564998780219,10.0.2.15,52.98.228.50,443,tcp,tls,253820,12074,32,3412,30,15486,62,normal,-
841677653073501906,10.0.2.15,18.66.112.119,443,tcp,tls,341018,16398,44,4816,42,21214,86,normal,-
-4186234309860358093,10.0.2.15,104.18.29.126,80,tcp,http,230692,2592,32,2408,34,5000,66,normal,-
4230283548546822130,10.0.2.15,65.9.9.138,80,tcp,http,635083,23552,104,13854,110,37406,214,normal,-
5426167985659336792,10.0.2.15,54.198.170.253,443,tcp,tls,131440,12636,40,4192,40,16828,80,normal,-
-3438385484355420639,10.0.2.15,65.9.95.126,443,tcp,tls,406495,39317,79,9060,82,48377,161,normal,-
-1069542238550720391,10.0.2.15,151.101.194.62,443,tcp,tls,172494,16843,45,5402,46,22245,91,normal,-
8209185320575757642,10.0.2.15,208.74.123.84,443,tcp,tls,7062,16464,30,3438,26,19902,56,normal,-
-2085641080418034022,10.0.2.15,142.250.27.157,443,udp,-,24381,58027,80,20466,55,78493,135,normal,-
-7458390501003496637,10.0.2.15,151.101.193.91,443,tcp,tls,594,17690,38,4214,36,21904,74,normal,-
8516001246984497971,10.0.2.15,65.9.99.47,443,tcp,tls,342074,16118,46,4670,40,20788,86,normal,-
-6509523996589787439,10.0.2.15,192.124.249.41,80,tcp,http,274698,24201,62,7223,63,31424,125,normal,-
-4750545588055745119,10.0.2.15,142.251.36.81,443,udp,-,521,23499,24,5955,21,29454,45,normal,-
-3710549163149565711,10.0.2.15,54.190.116.241,443,tcp,tls,57558,19674,96,35396,92,55070,188,normal,-
290850912069056505,10.0.2.15,195.128.8.101,443,tcp,tls,20754,12694,28,3654,30,16348,58,normal,-
1333339995943918677,10.0.2.15,151.101.1.188,443,tcp,tls,342602,15480,46,4834,42,20314,88,normal,-
-2868413815327194332,10.0.2.15,95.100.146.17,443,tcp,tls,194792,3452782,2770,95252,1169,3548034,3939,normal,-
7306046197073827186,10.0.2.15,65.9.94.80,80,tcp,http,232292,3924,32,2742,34,6666,66,normal,-
3193891433208516721,10.0.2.15,104.17.71.176,443,tcp,tls,341348,53648,70,5584,54,59232,124,normal,-
6578284958902101075,10.0.2.15,104.16.132.229,443,udp,-,304,15096,26,4830,18,19926,44,normal,-
3994145844565042080,10.0.2.15,54.186.100.168,443,tcp,tls,103006,21578,106,42494,96,64072,202,normal,-
2288911981009265859,10.0.2.15,52.98.228.50,443,udp,-,772,62852,58,8498,30,71350,88,normal,-
-465841487135036185,10.0.2.15,104.16.99.56,443,tcp,tls,343842,13910,42,4952,44,18862,86,normal,-
-7976360165077490234,10.0.2.15,40.126.32.138,443,tcp,tls,2064,13396,26,3772,24,17168,50,normal,-
7419549731826568645,10.0.2.15,65.9.95.111,443,tcp,-,58892,7546,17,2434,19,9980,36,normal,-
-7311400292469444829,10.0.2.15,54.221.154.46,443,tcp,tls,62962,13234,32,4046,34,17280,66,normal,-
-3008294159654903684,10.0.2.15,142.250.201.195,443,tcp,tls,934,12906,40,4478,36,17384,76,normal,-
6009194905680084733,10.0.2.15,65.9.95.116,443,tcp,tls,234586,136117,189,20387,155,156504,344,normal,-
-3246730305165078283,10.0.2.15,104.76.158.233,443,tcp,tls,82931,135089,124,8644,87,143733,211,normal,-
4362576910349300152,10.0.2.15,104.18.29.126,443,tcp,tls,584,42016,54,4390,40,46406,94,normal,-
3851118678551073962,10.0.2.15,104.16.240.21,443,tcp,tls,2818,14946,38,6992,40,21938,78,normal,-
6728979249381038264,10.0.2.15,151.101.193.171,443,tcp,tls,342062,15442,44,4744,40,20186,84,normal,-
160647506127779633,10.0.2.15,52.84.150.63,443,tcp,tls,342108,16036,44,4682,42,20718,86,normal,-
8426761678344032941,10.0.2.15,65.9.95.108,443,tcp,tls,515144,40758,130,13886,123,54644,253,normal,-
3121722474369506238,10.0.2.15,65.9.95.48,443,tcp,tls,526389,125536,162,19128,138,144664,300,normal,-
-6970021230314928321,10.0.2.15,52.95.115.255,443,tcp,tls,1886,13798,18,2046,18,15844,36,normal,-
-3356769002025956640,10.0.2.15,54.195.241.43,443,tcp,tls,3079,5908,13,2475,16,8383,29,normal,-
-5872748986905112952,10.0.2.15,51.132.193.104,443,tcp,tls,392671,75850,184,62425,187,138275,371,normal,-
6777222039499414153,10.0.2.15,65.9.95.13,443,tcp,tls,153432,1996827,1544,64851,799,2061678,2343,normal,-
4633307790537839752,10.0.2.15,23.73.207.9,443,tcp,tls,240992,25396,54,4924,46,30320,100,normal,-
3280642609679768952,10.0.2.15,44.240.21.97,443,tcp,tls,118878,21050,77,13494,73,34544,150,normal,-
6875135542759040990,10.0.2.15,104.17.78.34,443,tcp,tls,4177,21223,60,8432,63,29655,123,normal,-
6022913326359785792,10.0.2.15,104.18.29.126,443,udp,-,306,13172,22,3860,12,17032,34,normal,-
6444665348556608640,10.0.2.15,54.76.21.24,443,tcp,tls,31386,48011,68,7074,67,55085,135,normal,-
7041886118400185706,10.0.2.15,151.101.65.171,443,tcp,tls,340750,14896,46,4844,42,19740,88,normal,-
-6550625879676303502,10.0.2.15,98.98.134.243,443,tcp,tls,934,8508,12,1830,14,10338,26,normal,-
163858586528116233,10.0.2.15,65.9.99.209,443,tcp,tls,140363,61965,126,22211,124,84176,250,normal,-
3955020390153630583,10.0.2.15,104.16.42.65,443,tcp,-,2152,120,2,256,4,376,6,normal,-
-2995958178362062736,10.0.2.15,157.90.0.13,443,tcp,tls,77861,72794,201,81722,198,154516,399,normal,-
-1228098475481135350,10.0.2.15,193.0.160.131,443,tcp,tls,264,6328,12,1722,12,8050,24,normal,-
-8699430942535591039,10.0.2.15,65.9.95.109,443,tcp,tls,8953,45192,67,15174,61,60366,128,normal,-
1815476722159312450,10.0.2.15,35.171.98.11,443,tcp,tls,3215,21783,65,8613,65,30396,130,normal,-
3518084315979058427,10.0.2.15,18.170.254.31,443,tcp,tls,6926,13446,38,4682,37,18128,75,normal,-
-7151336404639626181,10.0.2.15,162.247.241.14,443,tcp,tls,271618,35169,87,12717,97,47886,184,normal,-
-1526880257438384144,10.0.2.15,52.11.51.230,443,tcp,tls,36200,34226,80,11904,73,46130,153,normal,-
4320317627368721082,10.0.2.15,185.89.210.141,443,tcp,tls,20884,10594,27,3825,33,14419,60,normal,-
-4157818824908744428,10.0.2.15,104.19.167.117,443,tcp,tls,2269,46632,97,11808,94,58440,191,normal,-
3908680944958705851,10.0.2.15,65.9.95.120,443,tcp,tls,46944,7558581,5654,155607,1865,7714188,7519,normal,-
8236969843965518292,10.0.2.15,185.255.84.152,443,tcp,tls,24133,23566,54,5766,52,29332,106,normal,-
7647577674259112338,10.0.2.15,18.66.97.31,443,tcp,tls,177587,39562,67,7711,63,47273,130,normal,-
7698223300639476397,10.0.2.15,52.222.226.205,80,tcp,http,268830,17906,57,9795,60,27701,117,normal,-
-987497388979036545,10.0.2.15,185.125.188.55,443,tcp,tls,10880,57200,66,15478,46,72678,112,normal,-
799222159060947139,10.0.2.15,54.74.250.190,443,tcp,tls,64357,201884,189,38958,114,240842,303,normal,-
-6032865946881850616,10.0.2.15,65.9.95.72,443,tcp,tls,2493,38640,88,11248,88,49888,176,normal,-
-6812312799352988453,10.0.2.15,185.255.84.150,443,tcp,tls,41502,20536,42,4386,38,24922,80,normal,-
1051645817201846953,10.0.2.15,92.223.21.23,443,tcp,tls,32290,27452,44,7778,40,35230,84,normal,-
-4797038312946778327,10.0.2.15,65.9.95.36,443,tcp,tls,141418,101106,92,6382,62,107488,154,normal,-
1404913472450962842,10.0.2.15,65.9.97.56,443,tcp,tls,248665,213138,193,10911,108,224049,301,normal,-
-5519061208227815927,10.0.2.15,104.22.73.232,443,tcp,tls,128652,11036,36,4866,36,15902,72,normal,-
6245407082372919184,10.0.2.15,52.203.211.182,443,tcp,tls,69720,33817,79,15866,78,49683,157,normal,-
-895413000362485270,10.0.2.15,203.30.190.247,443,tcp,tls,2636,4809628,3406,77566,1226,4887194,4632,normal,-
468740632501061383,10.0.2.15,104.17.183.177,443,tcp,tls,302,6860,18,2330,20,9190,38,normal,-
-7440469228002171264,10.0.2.15,52.59.118.245,443,tcp,tls,30034,14486,44,11778,42,26264,86,normal,-
-1719392744507588902,10.0.2.15,104.17.79.34,443,tcp,tls,126648,339902,268,11186,134,351088,402,normal,-
-7471448264385234482,10.0.2.15,52.28.39.77,443,tcp,tls,118650,13442,28,6134,28,19576,56,normal,-
-4084865639077135750,10.0.2.15,20.190.160.17,443,tcp,tls,349435,89878,119,10250,91,100128,210,normal,-
2558028549479938695,10.0.2.15,92.223.84.84,443,tcp,tls,10119,8301190,5734,109185,1860,8410375,7594,normal,-
5574080610350094879,10.0.2.15,65.9.98.186,443,tcp,tls,182822,106273,106,6909,61,113182,167,normal,-
2982358439886909940,10.0.2.15,104.19.148.8,443,tcp,tls,1793,16294,33,4915,30,21209,63,normal,-
6684427985164470387,10.0.2.15,172.255.6.249,443,tcp,tls,33002,16621,30,5942,31,22563,61,normal,-
-7469331633921366007,10.0.2.15,65.9.95.4,443,tcp,tls,894,62312,56,4464,42,66776,98,normal,-
-888237650413484919,10.0.2.15,23.75.66.132,443,tcp,tls,119758,44632,54,5076,50,49708,104,normal,-
-5824420366874125134,10.0.2.15,142.251.37.112,443,tcp,tls,3998,69734,115,12428,103,82162,218,normal,-
-9140476693274707490,10.0.2.15,65.9.95.67,443,tcp,tls,62652,227077,188,10019,117,237096,305,normal,-
2342004120297226426,10.0.2.15,65.9.95.7,443,tcp,tls,772,92640,88,4852,48,97492,136,normal,-
3989363453418747832,10.0.2.15,65.9.95.118,443,tcp,tls,192532,49331,87,10244,84,59575,171,normal,-
-8655219581032832271,10.0.2.15,65.9.95.60,443,tcp,tls,154148,522692,440,50890,388,573582,828,normal,-
7315229375623117216,10.0.2.15,216.52.2.30,443,tcp,tls,31582,26736,56,23902,56,50638,112,normal,-
-2759779501355747973,10.0.2.15,65.9.95.124,443,tcp,tls,934,38934,50,4516,42,43450,92,normal,-
2198057316838504494,10.0.2.15,51.38.59.46,443,tcp,tls,1962,1988968,1411,31587,469,2020555,1880,normal,-
1727844266984784953,10.0.2.15,65.9.95.47,443,tcp,tls,2480,66514,121,17868,110,84382,231,normal,-
1795973225356869252,10.0.2.15,65.9.95.40,443,tcp,tls,144330,57324,114,12210,106,69534,220,normal,-
9202410475495364137,10.0.2.15,51.161.115.163,443,tcp,tls,3940,12534,30,4014,30,16548,60,normal,-
3584263130791469914,10.0.2.15,44.196.249.209,443,tcp,tls,125658,21270,46,11462,44,32732,90,normal,-
5833465727090962619,10.0.2.15,65.9.95.99,443,tcp,tls,1092,12492,26,6972,26,19464,52,normal,-
-6396944014909608309,10.0.2.15,162.55.233.28,443,tcp,tls,4116,17110,36,11438,36,28548,72,normal,-
-451379857020322872,10.0.2.15,54.90.73.51,443,tcp,tls,191710,32055,66,8027,65,40082,131,normal,-
-152471949476920769,10.0.2.15,65.9.95.68,443,tcp,tls,135936,64210,96,18984,82,83194,178,normal,-
2895429978377990500,10.0.2.15,3.94.12.238,443,tcp,tls,1910,694,8,1614,10,2308,18,normal,-
-6234454556438185602,10.0.2.15,18.188.81.199,443,tcp,tls,1870,18032,30,2946,30,20978,60,normal,-
-8817423729788551636,10.0.2.15,34.201.195.249,443,tcp,tls,121154,15968,38,5186,36,21154,74,normal,-
8064626746856209589,10.0.2.15,65.9.95.5,443,tcp,tls,118326,58140,60,4728,46,62868,106,normal,-
-6379811791550867138,10.0.2.15,34.102.240.186,443,tcp,tls,850,16288,28,3708,26,19996,54,normal,-
-4228516403626811281,10.0.2.15,13.107.226.44,443,tcp,tls,1880,13042,26,3844,26,16886,52,normal,-
-5172761526954857223,10.0.2.15,77.75.77.235,443,tcp,tls,584,12624,24,3518,26,16142,50,normal,-
-8443448331976323296,10.0.2.15,34.120.230.83,443,tcp,tls,1315,86940,91,6270,63,93210,154,normal,-
5206079933106633859,10.0.2.15,104.17.209.240,443,tcp,tls,235890,32808,48,4806,38,37614,86,normal,-
-2669927805119852386,10.0.2.15,65.9.92.135,443,tcp,tls,340726,16834,44,4824,44,21658,88,normal,-
-8803936069157554934,10.0.2.15,139.45.197.236,443,tcp,tls,2386,14632,28,3810,28,18442,56,normal,-
-1623859491172827954,10.0.2.15,2.16.2.91,443,tcp,tls,40644,274994,214,7636,98,282630,312,normal,-
-7061974798362155807,10.0.2.15,139.45.197.242,443,tcp,tls,2410,317904,248,14108,172,332012,420,normal,-
-5017114125020513368,10.0.2.15,52.17.23.209,443,tcp,tls,147785,70860,376,289650,361,360510,737,normal,-
860852025141945810,10.0.2.15,34.254.143.3,443,tcp,tls,177678,17116,68,36531,65,53647,133,normal,-
5744977165158671414,10.0.2.15,104.26.7.217,443,tcp,tls,952,58130,74,7088,54,65218,128,normal,-
-1321546088422537832,10.0.2.15,3.120.214.218,443,tcp,tls,21342,15278,32,6224,28,21502,60,normal,-
-9072985936096925368,10.0.2.15,65.9.95.85,443,tcp,tls,121016,227992,204,11677,126,239669,330,normal,-
-5764586561589576006,10.0.2.15,65.9.95.75,443,tcp,tls,118640,32252,44,4366,40,36618,84,normal,-
-1255449583080046549,10.0.2.15,174.137.133.18,443,tcp,tls,23642,13978,22,3634,24,17612,46,normal,-
-5481588116812058695,10.0.2.15,34.160.55.127,443,tcp,tls,59023,20807,53,7813,53,28620,106,normal,-
2637365136560347362,10.0.2.15,212.82.100.181,443,tcp,tls,3517,33344,60,8043,55,41387,115,normal,-
8514337714069777699,10.0.2.15,65.9.95.128,443,tcp,tls,251137,51716,81,10468,75,62184,156,normal,-
-8422913185937615356,10.0.2.15,34.160.158.95,443,tcp,tls,1396,153030,147,8324,89,161354,236,normal,-
-3960077249360706908,10.0.2.15,69.173.144.139,443,tcp,tls,68128,25628,38,8814,36,34442,74,normal,-
-4958576169661178762,10.0.2.15,34.254.166.85,443,tcp,tls,61480,20178,36,5025,38,25203,74,normal,-
2452469799694097021,10.0.2.15,104.26.6.139,443,tcp,tls,134638,11748,34,4374,34,16122,68,normal,-
732362094815374429,10.0.2.15,37.157.6.235,443,tcp,tls,2336,76522,68,4688,44,81210,112,normal,-
-4777383761748869101,10.0.2.15,18.132.218.242,443,tcp,tls,135027,33802,92,33204,94,67006,186,normal,-
-3222636605232246480,10.0.2.15,34.246.122.180,443,tcp,tls,118526,15218,36,8798,34,24016,70,normal,-
-9208335301031584880,10.0.2.15,35.201.79.141,443,tcp,tls,1096,68760,82,5772,58,74532,140,normal,-
-9205106366115570743,10.0.2.15,34.120.121.20,443,tcp,tls,2937,20807,52,10180,53,30987,105,normal,-
3714844971785774589,10.0.2.15,34.120.253.250,443,tcp,tls,1116,17534,40,4364,38,21898,78,normal,-
-1343852544657616473,10.0.2.15,20.82.209.183,443,tcp,tls,234386,16230,38,4870,34,21100,72,normal,-
-5136115852672248838,10.0.2.15,172.255.6.119,443,tcp,tls,32378,50657,55,11339,47,61996,102,normal,-
-7310479834832951586,10.0.2.15,65.9.95.73,443,tcp,tls,401220,36858,80,8525,75,45383,155,normal,-
4354508815358197463,10.0.2.15,95.100.146.72,443,tcp,tls,42012,76618,84,5756,60,82374,144,normal,-
-7560741562825596874,10.0.2.15,151.101.194.202,443,tcp,tls,123162,17436,36,4498,32,21934,68,normal,-
-6848800097764232877,10.0.2.15,139.45.195.8,443,tcp,tls,672,12158,24,3606,24,15764,48,normal,-
-6943423923679300506,10.0.2.15,185.89.208.11,443,tcp,tls,184189,32063,74,39670,75,71733,149,normal,-
6205702709977299034,10.0.2.15,65.9.95.20,443,tcp,tls,118132,16336,32,3964,32,20300,64,normal,-
6469640363503133327,10.0.2.15,65.9.95.21,443,tcp,tls,1972,375523,289,15184,209,390707,498,normal,-
-8066359343784467889,10.0.2.15,50.19.56.199,443,tcp,tls,15401,21278,53,8330,50,29608,103,normal,-
-2007315991083440919,10.0.2.15,3.121.23.210,443,tcp,tls,4723,39858,86,10948,84,50806,170,normal,-
-6499996758346730632,10.0.2.15,203.29.52.242,443,tcp,tls,776,8868,20,3566,22,12434,42,normal,-
-2203568041638678488,10.0.2.15,65.9.95.89,443,tcp,tls,177023,97631,99,7452,68,105083,167,normal,-
-7478514464085735682,10.0.2.15,65.9.95.3,443,tcp,tls,342768,16732,44,4796,44,21528,88,normal,-
-4540439030685607736,10.0.2.15,185.89.210.212,443,tcp,tls,21096,9970,28,9622,28,19592,56,normal,-
-6896372810050710786,10.0.2.15,87.240.169.2,443,tcp,tls,235852,259146,200,11670,168,270816,368,normal,-
3693918308305206820,10.0.2.15,185.89.210.244,443,tcp,tls,51140,103826,145,70491,111,174317,256,normal,-
1284423869553187538,10.0.2.15,77.75.79.234,443,tcp,tls,1964,142706,126,7666,76,150372,202,normal,-
233542432808172136,10.0.2.15,104.21.235.147,443,tcp,tls,826,224430,180,7188,90,231618,270,normal,-
-1658534980165544687,10.0.2.15,18.196.91.239,443,tcp,tls,688,12074,32,4374,32,16448,64,normal,-
6167765897079430998,10.0.2.15,87.240.132.78,443,tcp,tls,247064,702924,574,37598,438,740522,1012,normal,-
7845566292764558679,10.0.2.15,104.18.43.178,443,tcp,tls,21336,36090,100,73916,102,110006,202,normal,-
2296884999045620256,10.0.2.15,35.157.179.180,443,tcp,tls,2102,68424,68,4560,36,72984,104,normal,-
-6675758264655312448,10.0.2.15,104.17.210.204,443,tcp,tls,474022,15136,58,6170,56,21306,114,normal,-
-6628651677775603790,10.0.2.15,144.21.35.228,443,tcp,tls,36648,23282,42,6954,42,30236,84,normal,-
8081489988833647995,10.0.2.15,142.91.159.111,443,tcp,tls,20942,13148,22,3872,20,17020,42,normal,-
932090627628421092,10.0.2.15,65.9.95.81,443,tcp,tls,188655,24365,54,7467,55,31832,109,normal,-
1560223878221902309,10.0.2.15,52.57.98.143,443,tcp,tls,34516,16028,48,9768,44,25796,92,normal,-
-6782954893271436110,10.0.2.15,198.134.116.30,443,tcp,tls,21850,11334,22,3692,22,15026,44,normal,-
-6896929587440901029,10.0.2.15,107.154.132.121,443,tcp,tls,4807,37046,72,11178,70,48224,142,normal,-
8850165834139558964,10.0.2.15,44.207.172.20,443,tcp,tls,125840,11854,48,8686,46,20540,94,normal,-
-278963171438684393,10.0.2.15,67.220.228.201,443,tcp,tls,123122,22536,42,14638,42,37174,84,normal,-
5626101449169152061,10.0.2.15,151.101.129.184,443,tcp,tls,340680,14366,46,4842,42,19208,88,normal,-
-5822935609631555278,10.0.2.15,104.22.55.232,443,tcp,tls,135802,9416,30,4268,30,13684,60,normal,-
-65073182310160662,10.0.2.15,44.195.94.71,443,tcp,tls,70896,23180,66,16005,67,39185,133,normal,-
-7706025186929193410,10.0.2.15,104.21.10.15,443,tcp,tls,638,15100,36,3970,32,19070,68,normal,-
-4903030553432842256,10.0.2.15,77.88.21.119,443,tcp,tls,14892,174272,150,14158,90,188430,240,normal,-
5555013415316134995,10.0.2.15,147.75.83.64,443,tcp,tls,1274,7838,14,1938,16,9776,30,normal,-
7812290978511352329,10.0.2.15,65.9.95.44,443,tcp,tls,117568,15222,34,3918,30,19140,64,normal,-
8495768095586378490,10.0.2.15,54.216.177.225,443,tcp,tls,119542,14772,32,4280,34,19052,66,normal,-
126755592923813132,10.0.2.15,174.137.133.16,443,tcp,tls,24716,12582,22,3630,24,16212,46,normal,-
95479864886595541,10.0.2.15,34.102.253.54,443,tcp,tls,1932,14054,40,9984,42,24038,82,normal,-
-2245144925712917067,10.0.2.15,65.9.95.54,443,tcp,tls,42220,790454,748,146480,598,936934,1346,normal,-
-6624064327326836965,10.0.2.15,91.228.74.200,443,tcp,tls,1665,28741,50,5996,44,34737,94,normal,-
3269741807928676553,10.0.2.15,54.149.64.42,443,tcp,tls,130674,14728,46,10542,48,25270,94,normal,-
457228238490675292,10.0.2.15,35.169.13.59,443,tcp,tls,130705,12562,51,10394,54,22956,105,normal,-
-353847185471227417,10.0.2.15,65.9.95.55,443,tcp,tls,136062,104240,98,7282,86,111522,184,normal,-
2609962477237439753,10.0.2.15,65.9.95.101,443,tcp,tls,128176,28448,42,4676,38,33124,80,normal,-
3741817841271102383,10.0.2.15,104.17.186.177,443,tcp,tls,1038,239788,188,7004,88,246792,276,normal,-
4476143997418667898,10.0.2.15,185.89.211.132,443,tcp,tls,20562,9148,24,3372,22,12520,46,normal,-
4784513732360028010,10.0.2.15,35.190.55.95,443,tcp,tls,1522,24334,48,5664,48,29998,96,normal,-
8670154170192724079,10.0.2.15,146.75.122.62,443,tcp,tls,340940,12374,44,4680,42,17054,86,normal,-
1984592903592021631,10.0.2.15,104.64.173.52,443,tcp,tls,40748,15872,26,3618,28,19490,54,normal,-
-3397964265551609886,10.0.2.15,213.227.153.223,443,tcp,tls,61350,10488,32,4740,32,15228,64,normal,-
-1592751673940894449,10.0.2.15,35.190.10.96,443,tcp,tls,3196,22110,54,16354,52,38464,106,normal,-
-1061736277375593181,10.0.2.15,65.9.95.17,443,tcp,tls,117824,21890,34,4036,32,25926,66,normal,-
6680370500776339225,10.0.2.15,92.223.23.231,443,tcp,tls,20966,11688,20,3558,22,15246,42,normal,-
-6214695005014652987,10.0.2.15,65.9.95.34,443,tcp,tls,12779,19643,48,8486,46,28129,94,normal,-
-1242142696156280855,10.0.2.15,68.219.88.97,443,tcp,tls,253266,17866,44,6084,40,23950,84,normal,-
-7802483234472788376,10.0.2.15,213.19.162.41,443,tcp,tls,38923,36911,77,14924,75,51835,152,normal,-
-3484531138767236904,10.0.2.15,18.194.236.132,443,tcp,tls,11333,21486,64,14492,65,35978,129,normal,-
7725736046215628235,10.0.2.15,178.250.1.8,443,tcp,tls,23072,12400,48,12116,46,24516,94,normal,-
2118625002551066132,10.0.2.15,151.101.2.152,443,tcp,tls,341480,13782,44,4842,42,18624,86,normal,-
-530796320515523192,10.0.2.15,65.9.95.33,443,tcp,tls,300,11478,20,3284,20,14762,40,normal,-
7651651091905442668,10.0.2.15,65.9.95.90,443,tcp,tls,118412,54088,58,4622,44,58710,102,normal,-
-2502653326249638817,10.0.2.15,195.168.10.172,443,tcp,tls,44474,42502,48,4496,30,46998,78,normal,-
-8060570387467241398,10.0.2.15,205.185.216.10,443,tcp,tls,20544,99712,90,4914,52,104626,142,normal,-
5998960270412186700,10.0.2.15,65.9.95.91,443,tcp,tls,342102,17064,46,4900,46,21964,92,normal,-
2200890029071061875,10.0.2.15,65.9.95.2,443,tcp,tls,116794,15414,36,4242,34,19656,70,normal,-
4225869219072851648,10.0.2.15,87.240.169.3,443,tcp,tls,236406,586458,426,22914,376,609372,802,normal,-
6896606909957208059,10.0.2.15,141.95.98.64,443,tcp,tls,12754,15086,32,8872,34,23958,66,normal,-
-1333456058343390742,10.0.2.15,95.142.206.2,443,tcp,tls,235470,31142,42,4490,36,35632,78,normal,-
1417501579949771170,10.0.2.15,87.240.169.1,443,tcp,tls,236462,543090,392,19026,304,562116,696,normal,-
-1154309196933431950,10.0.2.15,172.67.9.169,443,tcp,tls,117710,9646,28,4440,26,14086,54,normal,-
-4273944900314771264,10.0.2.15,65.9.95.25,443,tcp,tls,440,9672,22,2812,22,12484,44,normal,-
-8439250987819713697,10.0.2.15,34.160.111.29,443,tcp,tls,792,11194,36,4312,34,15506,70,normal,-
-942355535977350117,10.0.2.15,146.75.121.188,443,tcp,tls,341092,16528,46,4840,42,21368,88,normal,-
-2797569086388359249,10.0.2.15,92.223.51.163,443,tcp,tls,20672,45598,46,5384,44,50982,90,normal,-
-4126874387449802964,10.0.2.15,65.9.95.19,443,tcp,tls,117082,41738,50,4374,40,46112,90,normal,-
8930593440659163992,10.0.2.15,65.9.95.125,443,tcp,tls,1494,18080,28,3244,30,21324,58,normal,-
6419915458965473246,10.0.2.15,104.18.73.127,443,tcp,tls,119226,66590,68,7428,58,74018,126,normal,-
2473064363156698315,10.0.2.15,35.201.104.135,443,tcp,tls,1478,13838,38,4346,36,18184,74,normal,-
1518857217307377814,10.0.2.15,3.122.212.39,443,tcp,tls,32625,25177,43,8084,46,33261,89,normal,-
-6533128024063420771,10.0.2.15,52.54.237.110,443,tcp,tls,9171,20203,43,8492,48,28695,91,normal,-
3855670872280827119,10.0.2.15,142.251.36.73,443,tcp,tls,342254,12288,38,4046,40,16334,78,normal,-
-8715501488296533241,10.0.2.15,151.101.194.114,443,tcp,tls,341548,18022,48,4794,44,22816,92,normal,-
5537873413305391113,10.0.2.15,65.9.95.63,443,tcp,tls,118821,29958,41,4210,36,34168,77,normal,-
5967744783205221709,10.0.2.15,172.67.70.134,443,tcp,tls,234860,40800,62,5980,50,46780,112,normal,-
8618628042160892841,10.0.2.15,23.195.249.33,443,tcp,tls,119976,10946,26,3884,28,14830,54,normal,-
-5526132097763076593,10.0.2.15,3.225.78.121,443,tcp,tls,61568,14808,40,10322,42,25130,82,normal,-
-1665061439710077822,10.0.2.15,52.44.141.176,443,tcp,tls,65500,18186,40,6288,40,24474,80,normal,-
-3690432968531801520,10.0.2.15,93.186.227.129,443,tcp,tls,236478,338882,256,14320,218,353202,474,normal,-
-1057392938974686026,10.0.2.15,67.202.105.21,443,tcp,tls,21188,15718,44,11914,44,27632,88,normal,-
-2070409975994427176,10.0.2.15,104.17.184.177,443,tcp,tls,802,10690,28,5438,28,16128,56,normal,-
7534062622530496485,10.0.2.15,54.208.2.215,443,tcp,tls,35574,21616,74,25172,70,46788,144,normal,-
9063605713582279228,10.0.2.15,35.204.130.99,443,tcp,tls,736,14868,24,3784,26,18652,50,normal,-
-4125806691396714047,10.0.2.15,54.229.214.237,443,tcp,tls,2050,6662,14,1830,14,8492,28,normal,-
-2908955085507748758,10.0.2.15,35.157.93.158,443,tcp,tls,121060,22638,50,19614,54,42252,104,normal,-
-8484627518814049703,10.0.2.15,52.51.196.127,443,tcp,tls,102980,43194,64,24008,62,67202,126,normal,-
-6650320649651406914,10.0.2.15,162.19.19.14,443,tcp,tls,20490,18152,26,3576,24,21728,50,normal,-
-9046895477549653874,10.0.2.15,52.30.94.108,443,tcp,tls,1844,5728,10,1722,12,7450,22,normal,-
-2304340529434450166,10.0.2.15,104.244.42.197,443,tcp,tls,634948,13640,68,12678,70,26318,138,normal,-
-1918651739237940094,10.0.2.15,65.9.9.204,443,tcp,tls,148232,27226,104,25824,80,53050,184,normal,-
328955173942875880,10.0.2.15,108.138.7.125,443,tcp,tls,38074,2047242,1506,81676,1300,2128918,2806,normal,-
4349335357968622927,10.0.2.15,104.96.147.215,443,tcp,tls,232288,25584,58,5122,52,30706,110,normal,-
3653169688154594026,10.0.2.15,18.66.122.128,443,tcp,tls,225276,16242,46,5532,46,21774,92,normal,-
4244028548521961557,10.0.2.15,65.9.9.67,443,tcp,tls,342202,30580,54,5118,50,35698,104,normal,-
3492655233087889177,10.0.2.15,84.17.61.35,443,tcp,tls,117036,13544,32,3666,26,17210,58,normal,-
171780199623217872,10.0.2.15,37.157.6.233,443,tcp,tls,1864,12388,24,3606,24,15994,48,normal,-
-5006821560626417563,10.0.2.15,37.157.5.142,443,tcp,tls,1296,11218,28,7398,28,18616,56,normal,-
4917948542891615435,10.0.2.15,104.16.132.229,443,tcp,tls,342060,9276,36,3722,34,12998,70,normal,-
5402154257281588023,10.0.2.15,104.17.186.177,443,udp,-,386,13198,22,3656,10,16854,32,normal,-
-4164083950863639494,10.0.2.15,142.251.37.112,443,udp,-,736,20008,27,6059,18,26067,45,normal,-
-5236593171430415389,10.0.2.15,107.154.132.121,443,udp,-,27942,0,0,46167,33,46167,33,normal,-
67584742069591191,10.0.2.15,35.190.10.96,443,udp,-,15409,27806,43,22576,43,50382,86,normal,-
5516007288291312759,10.0.2.15,142.251.36.73,443,udp,-,26052,23243,36,8036,37,31279,73,normal,-
-410073559983941536,10.0.2.15,104.17.184.177,443,udp,-,17564,16114,30,18424,26,34538,56,normal,-
-5149409600733387724,10.0.2.15,142.250.27.156,443,udp,-,16151,17280,52,11452,36,28732,88,normal,-
4979597015124624492,10.0.2.15,216.239.36.178,443,udp,-,107868,30554,208,46068,144,76622,352,normal,-
-1670847900838596596,10.0.2.15,34.120.253.250,443,udp,-,386,11604,14,3802,12,15406,26,normal,-
-6045688770918707770,10.0.2.15,104.21.10.15,443,udp,-,360,10488,18,3658,10,14146,28,normal,-
-6783111915965837656,10.0.2.15,34.120.230.83,443,udp,-,332,13584,12,3796,12,17380,24,normal,-
-6762576769927129716,10.0.2.15,34.160.158.95,443,udp,-,12920,86451,80,7666,33,94117,113,normal,-
4133400779167183955,10.0.2.15,35.201.104.135,443,udp,-,18974,13552,22,4952,20,18504,42,normal,-
6444850148370513650,10.0.2.15,35.190.55.95,443,udp,-,1124,15984,22,6216,22,22200,44,normal,-
1893878848818657776,10.0.2.15,104.21.235.147,443,udp,-,556,10640,20,3862,12,14502,32,normal,-
-1099443085345262333,10.0.2.15,65.9.95.124,443,udp,-,16496,644058,464,22984,180,667042,644,normal,-
4002340536307712066,10.0.2.15,65.9.95.7,443,udp,-,326,15910,20,3836,12,19746,32,normal,-
-3821251700801573055,10.0.2.15,34.160.55.127,443,udp,-,5889,15901,25,7602,27,23503,52,normal,-
-4719475375540381498,10.0.2.15,34.102.240.186,443,udp,-,576,15064,16,3798,12,18862,28,normal,-
-5798054084993010997,10.0.2.15,151.101.193.91,443,udp,-,264,8376,8,3754,10,12130,18,normal,-
-7547998885021099240,10.0.2.15,35.201.79.141,443,udp,-,390,15072,16,3810,12,18882,28,normal,-
-6778914571809228057,10.0.2.15,34.160.111.29,443,udp,-,340,9714,12,3644,10,13358,22,normal,-
-4980755454696059591,142.251.36.100,10.0.2.15,46460,udp,-,64960,292910,766,1837520,1836,2130430,2602,normal,-
-1347957743644418044,10.0.2.15,142.250.201.195,443,udp,-,842,15040,24,4842,18,19882,42,normal,-
-1009591389109366746,10.0.2.15,65.9.92.135,443,udp,-,816,16606,24,4374,18,20980,42,normal,-
-8253003115607867060,10.0.2.15,65.9.95.103,443,tcp,-,225138,1120,16,1202,16,2322,32,normal,-
5511455094561559602,10.0.2.15,104.16.240.21,443,udp,-,13652,26040,46,20370,38,46410,84,normal,-
-7412649520086439728,10.0.2.15,65.9.95.85,443,udp,-,366,15878,20,4000,14,19878,34,normal,-
1755816280897081181,10.0.2.15,34.102.253.54,443,udp,-,332,12018,14,3806,12,15824,26,normal,-
-7544769950105085103,10.0.2.15,34.120.121.20,443,udp,-,1050,12058,14,3798,12,15856,26,normal,-
-2927548746972360359,44.237.163.41,10.0.2.15,41304,tcp,-,0,286,4,290,4,576,8,normal,-
-7792403635942835803,10.0.2.15,35.158.48.183,443,tcp,tls,888,23466,40,4496,40,27962,80,normal,-
-8771765347904565036,10.0.2.15,140.211.167.232,443,tcp,tls,87665,243612,269,24786,200,268398,469,normal,-
-977430659783846927,10.0.2.16,52.43.170.27,443,tcp,tls,5460,12740,42,5832,39,18572,81,normal,-
4454931733062074672,10.0.2.16,34.107.221.82,80,tcp,http,333847,4342,50,4664,52,9006,102,normal,-
-8767697348863135444,10.0.2.15,164.92.86.53,443,tcp,tls,24626,1140678,912,60272,816,1200950,1728,normal,-
7629721745917005641,10.0.2.15,151.101.193.7,443,tcp,tls,40780,12768,24,3556,24,16324,48,normal,-
6699109529430241032,10.0.2.15,151.101.193.181,443,tcp,tls,10226,634605,507,22699,281,657304,788,normal,-
555921293218883457,10.0.2.16,8.8.8.8,53,udp,dns,1525589,213640,1324,121384,1334,335024,2658,normal,-
-2889542151146028026,10.0.2.16,185.125.190.49,80,tcp,http,389,1323,15,1131,15,2454,30,normal,-
-6795034298006342220,10.0.2.16,224.0.0.251,5353,udp,-,6000,0,0,4214,22,4214,22,normal,-
-6401910841498129261,10.0.2.15,91.189.94.4,123,udp,ntp,188,180,2,180,2,360,4,normal,-
-7827776598775612071,10.0.2.15,65.9.95.76,443,tcp,-,148,320,4,308,4,628,8,normal,-
6088086790065128657,10.0.2.16,34.117.237.239,443,tcp,-,447926,9685,51,4811,50,14496,101,normal,-
3926881073626021105,10.0.2.16,104.18.7.29,443,tcp,tls,436,12182,24,2920,24,15102,48,normal,-
8102065844656973489,10.0.2.16,104.18.6.29,443,tcp,tls,172437,344599,285,17402,225,362001,510,normal,-
4962278805896350234,10.0.2.16,104.26.4.62,443,tcp,tls,304,12814,24,2920,24,15734,48,normal,-
5730941804567419320,10.0.2.16,142.251.36.106,443,tcp,tls,95751,26114,100,15175,98,41289,198,normal,-
1052571481022021109,52.43.170.27,10.0.2.16,51964,tcp,-,0,375,5,435,6,810,11,normal,-
4451616499032048377,10.0.2.16,157.240.30.27,443,tcp,tls,173923,1182851,957,54743,754,1237594,1711,normal,-
-3298756606280271006,10.0.2.16,185.125.190.17,80,tcp,http,248,882,10,754,10,1636,20,normal,-
656289625195491323,10.0.2.16,104.17.33.82,443,tcp,tls,172540,57959,94,9519,76,67478,170,normal,-
8144108723915377780,10.0.2.16,31.30.189.145,443,tcp,tls,3173,152344,195,19379,146,171723,341,normal,-
6650776296983186186,10.0.2.16,197.188.21.17,443,tcp,tls,2686,12308,40,4688,38,16996,78,normal,-
-1274240612827140433,10.0.2.16,142.251.37.110,443,tcp,tls,966010,92461,215,26167,211,118628,426,normal,-
-3428014729543725849,10.0.2.16,157.240.252.13,443,tcp,tls,646,12602,34,4360,32,16962,66,normal,-
-166278831031061251,10.0.2.16,34.120.208.123,443,tcp,tls,879551,64674,358,94564,320,159238,678,normal,-
-4199466948389896951,10.0.2.16,147.229.9.226,443,tcp,-,62742,60518,113,14147,110,74665,223,normal,-
-3218033910128740468,10.0.2.16,113.171.201.83,443,tcp,tls,3088,14427,40,4998,38,19425,78,normal,-
-871444374993190272,10.0.2.16,142.251.36.66,443,tcp,tls,607558,45501,128,14533,129,60034,257,normal,-
-4022301982633234297,10.0.2.16,142.251.36.97,443,tcp,tls,94896,115768,121,8993,92,124761,213,normal,-
4516134425321100689,10.0.2.16,147.229.2.90,80,tcp,-,15600,1560,11,1102,13,2662,24,normal,-
3726108408087710161,10.0.2.16,157.240.30.35,443,tcp,tls,4823,410348,443,34028,390,444376,833,normal,-
-5827573712538258796,10.0.2.16,172.67.71.230,443,tcp,tls,341990,28828,64,6958,58,35786,122,normal,-
930628390464900827,10.0.2.16,147.229.9.26,443,tcp,-,3267,56733,109,24011,119,80744,228,normal,-
-5137899579131776035,10.0.2.16,142.251.36.72,443,tcp,tls,638535,510222,466,24516,283,534738,749,normal,-
9203673451402718659,10.0.2.16,142.251.36.65,443,udp,-,784,28892,35,8133,24,37025,59,normal,-
2507050687541472935,10.0.2.16,147.229.2.90,443,tcp,tls,17348,1886969,1449,61976,821,1948945,2270,normal,-
2431157391377083869,10.0.2.16,142.251.36.100,443,tcp,tls,171316,65718,95,9021,76,74739,171,normal,-
3117860315026194736,10.0.2.16,142.251.36.99,80,tcp,-,1549853,49550,280,36499,297,86049,577,normal,-
-6975802863153544022,10.0.2.16,192.229.221.95,80,tcp,-,1248947,45274,238,32066,251,77340,489,normal,-
386095803183345207,10.0.2.16,142.251.37.110,443,udp,-,108091,341942,581,153375,490,495317,1071,normal,-
6271085589210849440,10.0.2.16,142.251.36.68,443,udp,-,26719,975496,830,85322,283,1060818,1113,normal,-
1420291537571234906,10.0.2.16,157.240.30.18,443,tcp,tls,107599,66984,185,20588,171,87572,356,normal,-
-3798755729008570011,10.0.2.16,31.30.189.206,443,tcp,tls,17784,16632,30,3657,33,20289,63,normal,-
-3477563163121290395,10.0.2.16,142.251.36.72,443,udp,-,35424,1505588,1153,50642,382,1556230,1535,normal,-
511676144987673145,10.0.2.16,157.240.30.3,443,tcp,tls,55614,27492,272,121170,236,148662,508,normal,-
6684591924277483897,10.0.2.16,142.251.36.86,443,tcp,tls,614779,215001,248,19319,200,234320,448,normal,-
5510428867385155808,10.0.2.16,104.16.56.101,443,tcp,tls,101716,16588,86,38491,86,55079,172,normal,-
2607207898322383831,10.0.2.16,157.240.236.8,443,tcp,tls,4227,16860,51,5936,46,22796,97,normal,-
-852859547303130424,10.0.2.16,17.253.144.10,443,tcp,tls,1047,21528,58,8512,55,30040,113,normal,-
920066934927295711,10.0.2.16,157.240.27.27,443,tcp,tls,722,12886,36,4364,32,17250,68,normal,-
4606225463074768063,10.0.2.16,142.251.36.138,443,tcp,tls,174328,48990,251,39176,239,88166,490,normal,-
8287026958817612128,10.0.2.16,104.19.187.97,443,tcp,-,367762,195011,223,17179,181,212190,404,normal,-
-8998835110709814391,10.0.2.16,31.30.189.76,443,tcp,tls,348515,326547,283,15026,157,341573,440,normal,-
-6936865044970457124,10.0.2.16,2.16.2.209,443,tcp,tls,245603,3849041,2790,75435,1091,3924476,3881,normal,-
4610749173200363800,10.0.2.16,142.251.36.68,443,tcp,tls,551812,13090,78,11240,76,24330,154,normal,-
3739193174901219556,10.0.2.16,144.2.9.1,443,tcp,tls,106864,9940,34,4572,28,14512,62,normal,-
5168186292420378075,10.0.2.16,13.107.226.44,443,tcp,tls,363887,239945,246,15292,149,255237,395,normal,-
1036097807689526967,10.0.2.16,13.107.42.14,443,tcp,tls,358614,200795,445,112037,413,312832,858,normal,-
-8159840324935346887,10.0.2.16,77.75.76.101,443,tcp,tls,164886,162346,219,23653,175,185999,394,normal,-
3308343874820643749,10.0.2.16,104.17.50.95,443,tcp,tls,204476,8868,32,3536,32,12404,64,normal,-
-8039637593471668636,10.0.2.16,35.186.249.72,443,tcp,tls,1400,45074,58,4966,48,50040,106,normal,-
1653607094873807129,10.0.2.16,142.251.36.78,443,tcp,tls,494627,134151,206,36696,175,170847,381,normal,-
795189007092595139,10.0.2.16,65.9.95.59,443,tcp,tls,342258,71754,86,6040,64,77794,150,normal,-
-2703407332142409261,10.0.2.16,142.251.36.67,443,tcp,tls,172352,198402,186,10215,114,208617,300,normal,-
2164753835317942943,10.0.2.16,77.75.78.196,443,tcp,tls,129746,101995,164,32594,150,134589,314,normal,-
-6747799080584074978,10.0.2.16,77.75.78.104,443,tcp,tls,60548,69584,92,13584,85,83168,177,normal,-
-7695116698924815291,10.0.2.16,34.107.204.85,443,tcp,tls,221552,38904,96,11823,99,50727,195,normal,-
4757117698891091416,10.0.2.16,151.101.194.110,443,tcp,tls,201606,13250,42,4618,38,17868,80,normal,-
953057724420120709,10.0.2.16,65.9.95.79,443,tcp,tls,726,182710,154,6878,76,189588,230,normal,-
7988163198531691083,10.0.2.16,95.100.146.66,80,tcp,http,802442,32005,151,20114,164,52119,315,normal,-
-8398141950734869549,10.0.2.16,13.107.21.200,443,tcp,tls,470373,75998,216,29885,209,105883,425,normal,-
-3092680548491485003,10.0.2.16,91.198.174.208,443,tcp,tls,5142,276614,265,20360,238,296974,503,normal,-
-8284728420422669486,10.0.2.16,65.9.94.208,443,tcp,tls,27627,34060,60,6527,63,40587,123,normal,-
6831046763203794238,10.0.2.16,77.75.79.195,443,tcp,tls,179651,6491471,5041,150415,2025,6641886,7066,normal,-
873688803244565077,10.0.2.16,77.75.77.195,443,tcp,tls,60699,196155,265,23780,213,219935,478,normal,-
-6971774953948654666,10.0.2.16,77.75.76.30,443,tcp,tls,504,12620,24,2920,24,15540,48,normal,-
-2819450643602078753,10.0.2.16,77.75.76.54,443,tcp,tls,55077,34014,87,12176,86,46190,173,normal,-
3931948625217508822,10.0.2.16,52.55.228.98,443,tcp,tls,258856,49497,118,16131,121,65628,239,normal,-
7543337035392233019,10.0.2.16,142.251.36.65,443,tcp,tls,512005,22344,57,6015,59,28359,116,normal,-
3054225616120216776,10.0.2.16,77.75.79.129,443,tcp,tls,110598,14110,40,4736,40,18846,80,normal,-
-1567160861074186438,10.0.2.16,20.119.174.243,443,tcp,tls,15711,21616,49,13408,53,35024,102,normal,-
-1854866099623584891,10.0.2.16,95.100.146.67,443,tcp,tls,40778,10376,32,3274,28,13650,60,normal,-
2218231645852088509,10.0.2.16,142.251.36.130,443,tcp,tls,758624,81526,209,24472,208,105998,417,normal,-
2918757927691298427,10.0.2.16,104.16.132.229,443,tcp,tls,198770,8968,32,3536,32,12504,64,normal,-
-1733611195511228186,10.0.2.16,104.17.211.204,443,tcp,tls,200250,13720,38,4510,36,18230,74,normal,-
8936264443423142436,10.0.2.16,100.22.17.150,443,tcp,tls,920,6536,12,1722,12,8258,24,normal,-
-4172035789462142905,10.0.2.16,77.75.78.30,443,tcp,tls,112722,365676,484,103656,428,469332,912,normal,-
7963902690081417884,10.0.2.16,77.75.78.20,443,tcp,tls,167642,568723,603,122013,395,690736,998,normal,-
-674632153497827081,10.0.2.16,142.251.36.134,443,tcp,tls,435441,18719,52,5706,54,24425,106,normal,-
1480106143158276254,10.0.2.16,142.251.36.141,443,tcp,tls,176194,17396,42,5050,45,22446,87,normal,-
4540810184359712917,10.0.2.16,77.75.79.69,443,tcp,tls,111414,36280,54,5940,42,42220,96,normal,-
5858473171590713353,10.0.2.16,23.195.248.219,443,tcp,tls,253381,2951915,2113,70918,1145,3022833,3258,normal,-
-7336822796298094841,10.0.2.16,23.195.248.244,443,tcp,tls,129745,291982,308,16746,184,308728,492,normal,-
2844938769317176990,10.0.2.16,34.240.144.110,443,tcp,tls,120924,18418,42,4578,40,22996,82,normal,-
1236853066760202202,10.0.2.16,95.100.146.18,443,tcp,tls,148146,1413757,1112,53500,742,1467257,1854,normal,-
-8707873060042350864,10.0.2.16,216.239.34.36,443,tcp,tls,511066,19306,56,5853,56,25159,112,normal,-
-346913476033258772,10.0.2.16,147.67.34.45,443,tcp,tls,11766,7800,18,2330,20,10130,38,normal,-
3969116338005705630,10.0.2.16,104.18.33.171,443,tcp,tls,198264,11866,40,4610,38,16476,78,normal,-
3054226409784241379,10.0.2.16,104.87.145.13,443,tcp,tls,326008,55317,118,17570,109,72887,227,normal,-
5656301412550850121,10.0.2.16,23.195.249.173,443,tcp,tls,246501,1631840,1360,81433,932,1713273,2292,normal,-
-8551731481905066486,10.0.2.16,141.95.47.55,443,tcp,tls,89610,32298,71,9808,73,42106,144,normal,-
-1390347504245490932,10.0.2.16,142.251.37.97,443,tcp,tls,341428,20404,42,4154,42,24558,84,normal,-
1814455539416217470,10.0.2.16,104.17.231.204,443,tcp,tls,198674,13304,58,6462,56,19766,114,normal,-
-2679438943844562040,10.0.2.16,20.42.72.131,443,tcp,tls,147728,27995,87,49111,87,77106,174,normal,-
3826402574543902165,10.0.2.16,77.75.78.157,443,tcp,tls,112598,19636,60,6568,54,26204,114,normal,-
-7696478136490385085,10.0.2.16,23.195.248.208,443,tcp,tls,108474,53800,72,5646,48,59446,120,normal,-
8154559999890908501,10.0.2.16,68.219.88.97,443,tcp,tls,64967,20283,48,7282,48,27565,96,normal,-
-520806908224446180,10.0.2.16,91.198.174.192,443,tcp,tls,4851,434375,359,24816,305,459191,664,normal,-
308413828362536891,10.0.2.16,77.75.76.104,443,tcp,tls,12186,48962,105,13574,91,62536,196,normal,-
6838273752315112328,10.0.2.16,13.37.25.97,443,tcp,tls,122409,28691,84,15583,80,44274,164,normal,-
603791440080934234,10.0.2.16,13.107.238.44,443,tcp,tls,134462,17090,42,5270,42,22360,84,normal,-
-4253348442422239647,10.0.2.16,151.101.193.140,443,tcp,tls,301911,20103,82,12286,79,32389,161,normal,-
-8662239447084800095,10.0.2.16,142.250.102.154,443,tcp,tls,340576,12698,38,3938,38,16636,76,normal,-
-4061463943436414124,10.0.2.16,52.167.30.171,443,tcp,tls,148440,57552,76,7956,56,65508,132,normal,-
-1089914005832795039,10.0.2.16,151.99.223.17,443,tcp,tls,1152,11860,30,4368,32,16228,62,normal,-
2401123353536396165,10.0.2.16,65.9.95.67,443,tcp,tls,201886,16094,40,4522,38,20616,78,normal,-
-2072431489735578651,10.0.2.16,145.239.237.56,443,tcp,tls,89377,9250,31,3550,30,12800,61,normal,-
5586476593898284990,10.0.2.16,23.195.248.26,443,tcp,tls,21495,26814,46,4859,43,31673,89,normal,-
5098740013109903998,10.0.2.16,104.244.42.5,443,tcp,tls,321054,21396,92,15141,92,36537,184,normal,-
-8163198893123624103,10.0.2.16,20.112.52.29,443,tcp,tls,63734,18140,36,3674,36,21814,72,normal,-
-4929530723988299329,10.0.2.16,37.157.6.234,443,tcp,tls,60536,77360,80,5162,50,82522,130,normal,-
-3872251181971568424,10.0.2.16,104.16.57.101,443,tcp,tls,174336,8714,30,3428,30,12142,60,normal,-
-2529852568883954081,10.0.2.16,34.248.177.106,443,tcp,tls,251301,47187,98,13427,93,60614,191,normal,-
-6821207161937100772,10.0.2.16,77.75.78.126,443,tcp,tls,107086,24496,45,4592,42,29088,87,normal,-
1767382195752830791,10.0.2.16,65.9.9.67,443,tcp,tls,158008,14650,36,3644,34,18294,70,normal,-
-8900381511187877331,10.0.2.16,77.75.79.165,443,tcp,tls,87168,14040,40,5104,40,19144,80,normal,-
2808012619260491767,10.0.2.16,185.89.210.180,443,tcp,tls,37416,16028,36,7602,32,23630,68,normal,-
5361278227085793952,10.0.2.16,141.95.47.54,443,tcp,tls,1432,9006,28,3288,28,12294,56,normal,-
-6780072538473698635,10.0.2.16,142.251.36.99,443,tcp,tls,89777,56776,83,7499,67,64275,150,normal,-
-1241944035556023640,10.0.2.16,192.229.221.185,443,tcp,tls,127768,18432,44,4000,40,22432,84,normal,-
-8047302430643188957,10.0.2.16,18.203.152.154,443,tcp,tls,774,12648,24,2622,24,15270,48,normal,-
-6628523300781624378,10.0.2.16,37.157.3.20,443,tcp,tls,107332,17290,42,6140,38,23430,80,normal,-
-3926027361069893287,10.0.2.16,185.66.189.42,443,tcp,tls,318,11010,16,2046,18,13056,34,normal,-
7384178074965326725,10.0.2.16,142.251.36.81,443,tcp,tls,65332,16012,36,5808,36,21820,72,normal,-
5456319479711518111,10.0.2.16,216.239.32.36,443,tcp,tls,322140,25649,70,7886,69,33535,139,normal,-
7179041029055308123,10.0.2.16,77.75.79.115,443,tcp,tls,111754,13436,34,4186,34,17622,68,normal,-
2247320786440147287,10.0.2.16,146.75.116.157,443,tcp,tls,323103,19543,83,9068,77,28611,160,normal,-
8223505807447780916,10.0.2.16,102.164.177.34,443,tcp,tls,1636,11898,34,4530,34,16428,68,normal,-
5482376743305522600,10.0.2.16,77.75.78.36,443,tcp,tls,110649,32550,104,24078,103,56628,207,normal,-
-8331600443245147135,10.0.2.16,104.19.155.83,443,tcp,tls,296901,12189,45,5142,45,17331,90,normal,-
6206344279693159650,10.0.2.16,142.251.36.73,443,tcp,tls,202708,11874,32,3644,34,15518,66,normal,-
7557741227046236681,10.0.2.16,104.244.42.131,443,tcp,tls,197472,14250,56,10478,58,24728,114,normal,-
1254298290560216336,10.0.2.16,40.126.32.74,443,tcp,tls,145988,38210,56,7156,46,45366,102,normal,-
-3477743176206780690,10.0.2.16,52.30.37.203,443,tcp,tls,125136,14158,44,10262,42,24420,86,normal,-
-4655490383706054633,10.0.2.16,142.251.36.131,443,tcp,tls,736115,54980,149,17404,147,72384,296,normal,-
-1450420158679180018,10.0.2.16,95.100.146.34,443,tcp,tls,204118,23046,68,6894,68,29940,136,normal,-
4031030586863139613,10.0.2.16,2.16.2.90,443,tcp,tls,40566,10372,32,3382,30,13754,62,normal,-
-4648814097750813830,10.0.2.16,77.75.77.222,443,tcp,tls,122368,537512,514,50060,374,587572,888,normal,-
6162888771538929590,10.0.2.16,20.50.201.195,443,tcp,tls,200177,29515,111,75424,114,104939,225,normal,-
-9057336850093194885,10.0.2.16,195.12.177.81,443,tcp,tls,1028,12400,36,4598,36,16998,72,normal,-
2695925519666393402,10.0.2.16,77.75.78.209,443,tcp,tls,70842,146366,136,7358,86,153724,222,normal,-
5494691808593500933,10.0.2.16,44.236.72.93,443,tcp,tls,155832,11918,38,4594,40,16512,78,normal,-
-9048322875339797574,10.0.2.16,54.194.182.124,443,tcp,tls,122194,13664,38,4610,38,18274,76,normal,-
-4365081935152363110,10.0.2.16,104.17.68.176,443,tcp,tls,200800,53374,66,5044,50,58418,116,normal,-
1354284456030242102,10.0.2.16,142.251.36.142,443,tcp,tls,376060,94469,154,14459,132,108928,286,normal,-
-6913893218206820273,10.0.2.16,151.101.192.176,443,tcp,tls,203524,95734,137,11574,118,107308,255,normal,-
8304395126142424375,10.0.2.16,192.117.112.82,443,tcp,tls,1358,11832,32,4480,34,16312,66,normal,-
-7714115563395301538,10.0.2.16,152.199.19.160,443,tcp,tls,129772,58276,74,5178,52,63454,126,normal,-
-7309355565317774009,10.0.2.16,54.186.100.168,443,tcp,tls,201434,35642,150,44882,152,80524,302,normal,-
8344928340287969537,10.0.2.16,142.251.36.86,443,udp,-,7863,605456,470,21787,149,627243,619,normal,-
4091493807387569509,10.0.2.16,142.251.36.100,443,udp,-,171400,2297535,2276,297078,1013,2594613,3289,normal,-
3313943510884292769,10.0.2.16,142.251.36.78,443,udp,-,38721,523107,567,295612,451,818719,1018,normal,-
-6287414071179355420,142.251.36.67,10.0.2.15,48804,tcp,-,815154,0,0,11012,64,11012,64,normal,-
-1767678313533240209,10.0.2.16,157.240.252.13,443,udp,-,244,11114,16,3652,10,14766,26,normal,-
570422410177690601,10.0.2.16,151.99.223.17,443,udp,-,540,10478,16,3652,10,14130,26,normal,-
788892041017295368,10.0.2.16,142.251.36.66,443,udp,-,69276,67536,169,38963,111,106499,280,normal,-
3878568061862574149,10.0.2.16,142.251.36.130,443,udp,-,120260,79148,166,40465,122,119613,288,normal,-
-5119736122463212995,10.0.2.16,142.251.36.99,443,udp,-,44040,731763,611,44978,276,776741,887,normal,-
4968680290831129389,10.0.2.16,104.17.50.95,443,udp,-,117796,467310,746,364540,526,831850,1272,normal,-
5386444824098195801,10.0.2.16,157.240.30.35,443,udp,-,157229,927900,1136,428994,696,1356894,1832,normal,-
70626607087146926,10.0.2.16,216.239.32.36,443,udp,-,136671,95026,251,64423,216,159449,467,normal,-
6266561879085253703,10.0.2.16,142.251.36.138,443,udp,-,4060,101208,116,15694,72,116902,188,normal,-
6111952915042534017,10.0.2.16,157.240.30.27,443,udp,-,29524,3281817,2880,110648,740,3392465,3620,normal,-
-8043385858954582044,10.0.2.16,104.17.49.95,443,udp,-,1265,63587,92,22410,79,85997,171,normal,-
-2995153967695568993,10.0.2.16,142.251.36.131,443,udp,-,214393,63844,234,50034,172,113878,406,normal,-
4579094343701784067,10.0.2.16,104.16.132.229,443,udp,-,478,15040,22,4282,12,19322,34,normal,-
-1046577645875348566,10.0.2.16,172.64.155.188,80,tcp,http,299647,10466,58,6900,63,17366,121,normal,-
1417561233542233,54.184.102.146,10.0.2.15,43916,tcp,-,812998,0,0,9380,64,9380,64,normal,-
-1043070916131923621,10.0.2.16,142.251.36.67,443,udp,-,30459,532704,467,50783,239,583487,706,normal,-
-8642298933783688196,10.0.2.16,31.30.189.145,443,udp,-,25532,2141129,1844,78129,419,2219258,2263,normal,-
-8461708937972194538,142.251.36.67,10.0.2.15,36916,tcp,-,814102,0,0,3840,64,3840,64,normal,-
-8479735108215113925,10.0.2.16,91.189.94.4,123,udp,ntp,392,180,2,180,2,360,4,normal,-
-6907425168923844199,35.158.48.183,10.0.2.15,57376,tcp,-,630030,0,0,5960,50,5960,50,normal,-
-7001903031074314455,10.0.2.16,142.250.102.154,443,udp,-,562,15440,22,4984,18,20424,40,normal,-
6114003993763059047,142.251.36.67,10.0.2.15,51780,tcp,-,814090,0,0,3840,64,3840,64,normal,-
3014620872040727742,10.0.2.16,142.251.36.142,443,udp,-,31058,151445,216,56359,185,207804,401,normal,-
-6671264027234661495,10.0.2.16,104.19.155.83,443,udp,-,154661,51286,103,23082,69,74368,172,normal,-
5275141728818806023,10.0.2.16,142.251.37.99,443,udp,-,39907,22230,31,8267,27,30497,58,normal,-
2494862323694970567,151.101.193.181,10.0.2.15,54766,tcp,-,259822,0,0,3946,30,3946,30,normal,-
2316626041205976963,10.0.2.16,104.17.33.82,443,udp,-,4178,28844,44,8320,34,37164,78,normal,-
-8485584519428082040,142.251.36.67,10.0.2.15,51764,tcp,-,814850,0,0,3840,64,3840,64,normal,-
-2361965566622748657,10.0.2.16,142.251.36.97,443,udp,-,23445,40954,50,12074,38,53028,88,normal,-
-7207676858604357441,10.0.2.16,74.125.128.127,19302,udp,-,110,148,2,124,2,272,4,normal,-
-2102410843817332128,151.101.193.7,10.0.2.15,59618,tcp,-,287610,0,0,2500,30,2500,30,normal,-
-1557697494118254828,10.0.2.16,113.171.201.83,443,udp,-,1260,15936,24,4152,16,20088,40,normal,-
-6047226682373397772,142.251.36.98,10.0.2.15,43000,tcp,-,814852,0,0,10508,64,10508,64,normal,-
-2549690849529059619,10.0.2.16,192.124.249.22,80,tcp,http,393337,17970,72,6498,72,24468,144,normal,-
-178283181124860203,34.120.208.123,10.0.2.15,45812,tcp,-,260246,0,0,5098,30,5098,30,normal,-
-421400446131172002,10.0.2.16,65.9.9.138,80,tcp,http,124690,3324,22,2202,24,5526,46,normal,-
269988911764994708,10.0.2.16,142.251.37.97,443,udp,-,11254,135286,134,10732,62,146018,196,normal,-
7391278220577904960,10.0.2.16,142.251.36.106,443,udp,-,1096,54741,63,12543,48,67284,111,normal,-
-8562901850251285060,10.0.2.16,102.164.177.34,443,udp,-,794,15930,24,4068,14,19998,38,normal,-
-7338498694699328751,10.0.2.16,31.30.189.76,443,udp,-,7946,5368826,3882,56480,544,5425306,4426,normal,-
-5673042442431580905,192.229.221.95,10.0.2.15,53382,tcp,-,760714,0,0,3600,60,3600,60,normal,-
9044514490975812365,10.0.2.16,142.251.36.81,443,udp,-,772,16014,20,4486,20,20500,40,normal,-
1921787391433855277,34.160.144.191,10.0.2.15,58012,tcp,-,372454,0,0,6674,38,6674,38,normal,-
-6272126671568445446,10.0.2.16,95.100.146.72,80,tcp,http,413628,30362,94,16960,94,47322,188,normal,-
9207766386572238881,192.229.221.95,10.0.2.15,53364,tcp,-,760704,0,0,3600,60,3600,60,normal,-
2580403350937781351,10.0.2.16,157.240.27.27,443,udp,-,638,11300,18,4054,16,15354,34,normal,-
3103632463381523293,10.0.2.16,204.79.197.203,80,tcp,http,132040,10716,28,3400,30,14116,58,normal,-
-8989143132317467498,151.101.194.49,10.0.2.15,46426,tcp,-,260198,0,0,3946,30,3946,30,normal,-
3140442559168761894,10.0.2.16,142.251.36.141,443,udp,-,1101,20522,37,7740,23,28262,60,normal,-
-7397000434082709245,10.0.2.16,195.12.177.81,443,udp,-,386,10486,16,3650,10,14136,26,normal,-
4986426586112011485,142.251.36.98,10.0.2.15,42998,tcp,-,814852,0,0,10508,64,10508,64,normal,-
-6635474915803671805,10.0.2.16,142.250.102.155,443,udp,-,1368,12431,46,11199,28,23630,74,normal,-
3982379639431794371,142.251.36.132,10.0.2.15,35946,tcp,-,814092,0,0,10508,64,10508,64,normal,-
1824921433370849892,10.0.2.16,104.16.123.96,443,udp,-,384,10480,18,3670,10,14150,28,normal,-
7866680695703645290,10.0.2.16,142.251.36.73,443,udp,-,1254,23785,33,7607,36,31392,69,normal,-
4337933512817644016,34.117.237.239,10.0.2.15,54598,tcp,-,372408,0,0,6226,38,6226,38,normal,-
-3506353657579606258,65.9.95.76,10.0.2.15,48940,tcp,-,839506,0,0,6598,66,6598,66,normal,-
8462635132057492931,10.0.2.16,17.253.73.201,80,tcp,http,97512,5348,20,2110,22,7458,42,normal,-
-7783055176978136709,192.229.221.95,10.0.2.15,53378,tcp,-,760704,0,0,3600,60,3600,60,normal,-
4620995066599849935,65.9.9.138,10.0.2.15,34248,tcp,-,814850,0,0,3840,64,3840,64,normal,-
2375003050361547527,10.0.2.16,142.251.36.110,443,udp,-,648,16512,22,6358,23,22870,45,normal,-
-6034780282914329651,10.0.2.16,34.107.204.85,443,udp,-,107352,54215,158,45701,175,99916,333,normal,-
4267544314332869471,10.0.2.16,157.240.236.8,443,udp,-,1798,24560,34,9842,18,34402,52,normal,-
3695350931633700127,142.251.36.132,10.0.2.15,35958,tcp,-,814836,0,0,10508,64,10508,64,normal,-
5004174102158680892,142.251.37.110,10.0.2.15,59928,tcp,-,814852,0,0,10508,64,10508,64,normal,-
6877638288334820601,151.101.194.49,10.0.2.15,46446,tcp,-,260436,0,0,3946,30,3946,30,normal,-
-2422021613976458152,10.0.2.16,104.18.21.226,80,tcp,http,23822,4632,14,1780,16,6412,30,normal,-
-7047536644031865224,10.0.2.16,216.239.34.36,443,udp,-,116636,30449,98,18847,68,49296,166,normal,-
-6379301177461182996,10.0.2.16,35.186.249.72,443,udp,-,330,15124,16,3974,14,19098,30,normal,-
-5306053897242272424,10.0.2.16,142.251.37.98,443,udp,-,296,5694,16,4358,12,10052,28,normal,-
-8482012531556641601,10.0.2.16,192.117.112.82,443,udp,-,738,16104,26,4240,16,20344,42,normal,-
-7484645995247900234,35.241.9.150,10.0.2.15,53418,tcp,-,373056,0,0,6226,38,6226,38,normal,-
-2138419312998084371,10.0.2.16,31.30.189.206,443,udp,-,4992,2603556,1938,63666,536,2667222,2474,normal,-
985704262512658559,10.0.2.16,142.251.36.134,443,udp,-,927,23443,34,7440,31,30883,65,normal,-
8311112712993671826,10.0.2.16,197.188.21.17,443,udp,-,1290,18648,28,4078,14,22726,42,normal,-
-1651279048934499602,8.8.8.8,10.0.2.16,50414,udp,-,0,0,0,416,2,416,2,normal,-
-4235442608602700990,10.0.2.16,8.253.240.113,443,tcp,-,176772,198569,236,17882,190,216451,426,normal,-
6215275842927043037,10.0.2.16,18.64.103.127,443,tcp,tls,349040,522360,462,26100,308,548460,770,normal,-
5209698745860068507,10.0.2.16,35.241.9.150,443,tcp,tls,171735,19926,51,5967,51,25893,102,normal,-
2011953740928999610,10.0.2.16,64.210.135.115,443,tcp,tls,17712,384906,371,23084,235,407990,606,normal,-
-8208618191886859661,10.0.2.16,143.204.89.26,443,tcp,tls,173444,592099,477,22149,283,614248,760,normal,-
-9121399275632021328,10.0.2.16,104.18.9.135,443,tcp,tls,6258,44661,130,17835,127,62496,257,normal,-
3562942173743268470,10.0.2.16,205.185.208.20,443,tcp,tls,16105,106012,109,7992,69,114004,178,normal,-
5356473180004751110,8.8.8.8,10.0.2.16,54837,udp,-,0,0,0,544,2,544,2,normal,-
-1706494102782465049,10.0.2.16,3.65.50.131,443,tcp,tls,30893,17532,51,5366,44,22898,95,normal,-
4226431430446455168,10.0.2.16,216.18.168.30,443,tcp,tls,10394,10128,20,2438,22,12566,42,normal,-
-8086172536145755695,10.0.2.16,66.254.114.38,443,tcp,tls,60907,13943,43,6142,42,20085,85,normal,-
-1141474615124110380,10.0.2.16,104.18.27.93,443,tcp,tls,937,18079,54,6870,52,24949,106,normal,-
7071124848404534846,10.0.2.16,209.140.129.87,443,tcp,-,6830,20411,32,9720,34,30131,66,normal,-
-8465133431531245132,10.0.2.16,205.185.208.142,443,tcp,tls,172261,183159,189,12927,128,196086,317,normal,-
-1635504165956928911,10.0.2.16,142.251.37.100,443,tcp,tls,344649,43934,112,13435,113,57369,225,normal,-
-8216237220397112614,10.0.2.16,23.195.248.65,443,tcp,tls,260703,3647382,2873,137901,1953,3785283,4826,normal,-
-4764041870921602836,10.0.2.16,185.152.64.17,443,tcp,tls,484763,346707,377,84409,279,431116,656,normal,-
-6258012005045210157,10.0.2.16,18.64.103.30,443,tcp,-,170433,7086,29,3136,25,10222,54,normal,-
-6966390313252758064,10.0.2.16,142.251.37.98,443,tcp,tls,1023,19421,51,6630,47,26051,98,normal,-
1210758547099972289,10.0.2.16,104.18.31.44,443,tcp,tls,4737,387036,330,21834,282,408870,612,normal,-
761917110336650839,10.0.2.16,91.235.134.131,443,tcp,tls,788,12350,30,4352,30,16702,60,normal,-
6643564119655505589,10.0.2.16,142.250.27.155,443,tcp,tls,1679,26260,75,8524,68,34784,143,normal,-
-3639112967747444625,10.0.2.16,91.235.133.182,443,tcp,tls,19892,118761,142,23125,115,141886,257,normal,-
4214081618929205267,10.0.2.16,209.140.136.167,443,tcp,tls,134731,30475,76,26360,76,56835,152,normal,-
3697587066275599776,10.0.2.16,142.251.36.74,443,tcp,tls,278586,494377,410,18982,246,513359,656,normal,-
-2231633119264036944,10.0.2.16,104.18.214.59,443,tcp,tls,1470,170216,157,8318,75,178534,232,normal,-
1756404275041241251,10.0.2.16,91.235.132.129,3478,tcp,-,9990,1880,23,2282,25,4162,48,normal,-
-6488630854603364178,10.0.2.16,18.158.95.160,443,tcp,tls,69598,12786,52,5802,48,18588,100,normal,-
3991372467894461998,10.0.2.16,23.195.249.37,443,tcp,tls,131995,783682,631,39573,482,823255,1113,normal,-
-3103705454911117196,10.0.2.16,185.152.64.17,443,udp,-,76273,30778,22,72748,52,103526,74,normal,-
6529439836275583269,10.0.2.16,34.160.144.191,443,tcp,tls,342560,24572,52,4606,46,29178,98,normal,-
1321539425492800843,10.0.2.16,209.140.135.178,443,tcp,tls,233428,18056,56,12756,56,30812,112,normal,-
-2354986915114244935,10.0.2.16,104.18.43.158,443,tcp,tls,327218,20625,73,16096,70,36721,143,normal,-
-684026872987225554,10.0.2.16,18.64.103.17,443,tcp,tls,2000,20778,39,4616,40,25394,79,normal,-
-1614263600449122262,8.8.8.8,10.0.2.16,59190,udp,-,0,0,0,368,2,368,2,normal,-
9119330218632544285,10.0.2.16,142.251.36.98,443,tcp,tls,172819,39100,98,11893,90,50993,188,normal,-
-4443717245758637705,10.0.2.16,104.18.32.68,80,tcp,http,991375,30883,163,18853,173,49736,336,normal,-
-5834647869973249880,10.0.2.16,34.111.24.118,80,tcp,-,126845,1660,22,1752,25,3412,47,normal,-
7338900847301649973,10.0.2.16,209.140.129.74,443,tcp,tls,233294,19030,58,10988,58,30018,116,normal,-
6355183602831870272,10.0.2.16,108.138.17.128,443,tcp,tls,348760,160981,173,12872,139,173853,312,normal,-
-4004177848366687829,10.0.2.16,185.199.111.154,443,tcp,-,374659,158938,225,20588,205,179526,430,normal,-
8200953829477986294,10.0.2.16,209.140.129.85,443,tcp,tls,364871,34089,90,13056,89,47145,179,normal,-
4951694771455714375,10.0.2.16,95.100.146.17,80,tcp,http,230896,3498,32,2736,34,6234,66,normal,-
6056032257478085219,10.0.2.16,209.140.129.67,443,tcp,tls,240222,23638,70,28152,72,51790,142,normal,-
-8375532483109842781,10.0.2.16,54.171.128.205,443,tcp,tls,172663,39540,64,6685,65,46225,129,normal,-
6918053276017521246,10.0.2.16,151.101.193.137,443,tcp,tls,209643,1215846,976,48598,611,1264444,1587,normal,-
-1240526550910595884,10.0.2.16,205.185.208.85,443,tcp,tls,20936,644458,462,14950,234,659408,696,normal,-
-7319436962199589148,10.0.2.16,142.251.36.102,443,tcp,tls,124225,27624,72,9064,72,36688,144,normal,-
3416740691051726891,10.0.2.16,91.235.132.129,3478,udp,-,8310,1092,10,1890,13,2982,23,normal,-
-3115476767192982881,10.0.2.16,209.140.136.209,443,tcp,tls,251688,32982,78,24388,80,57370,158,normal,-
-7598646211439269136,10.0.2.16,18.66.10.64,443,tcp,tls,172796,79112,85,6426,65,85538,150,normal,-
7439111704829010773,10.0.2.16,78.46.117.148,443,tcp,tls,19978,23068,48,5976,46,29044,94,normal,-
454958237937276048,10.0.2.16,18.66.12.143,80,tcp,http,773005,14075,107,9686,113,23761,220,normal,-
2337038892070315912,10.0.2.16,185.199.111.133,443,tcp,tls,215988,77247,138,12893,118,90140,256,normal,-
8147284192834932689,10.0.2.16,104.22.55.104,443,tcp,tls,250110,15378,42,4418,38,19796,80,normal,-
-6362942126582740847,95.100.146.66,10.0.2.16,47276,tcp,-,523654,10350,82,17276,82,27626,164,normal,-
-7568583008842473591,10.0.2.16,23.195.249.137,443,tcp,tls,251650,43452,140,21434,124,64886,264,normal,-
8201863998469984263,10.0.2.16,142.250.27.156,443,udp,-,1106,12224,16,9584,18,21808,34,normal,-
-9191970588261711548,10.0.2.16,66.254.114.41,443,tcp,tls,125124,271746,244,16416,162,288162,406,normal,-
-1127558051919133359,10.0.2.16,66.254.114.171,443,tcp,tls,123532,30952,54,6232,46,37184,100,normal,-
2871094963110457929,10.0.2.16,104.18.31.44,443,udp,-,36088,4968226,4359,189748,1597,5157974,5956,normal,-
1818884954597256087,10.0.2.16,91.189.91.157,123,udp,ntp,696,450,5,450,5,900,10,normal,-
-3803608391869731318,10.0.2.16,151.101.129.69,443,tcp,tls,4061,46570,103,10919,91,57489,194,normal,-
4523989642725908863,10.0.2.16,185.199.108.133,443,tcp,tls,336,10084,26,3028,26,13112,52,normal,-
-7667077439066521691,10.0.2.16,142.251.36.98,443,udp,-,26005,53426,92,24157,73,77583,165,normal,-
-531722396722784014,10.0.2.16,18.64.84.132,443,tcp,tls,342076,76736,82,4864,46,81600,128,normal,-
6672673755503562130,10.0.2.16,54.171.51.57,443,tcp,tls,166812,14598,46,7504,48,22102,94,normal,-
24832250053556729,10.0.2.16,142.251.37.100,443,udp,-,77549,1346542,1512,204049,777,1550591,2289,normal,-
-366121531400988223,10.0.2.16,66.211.163.13,443,tcp,tls,243246,41672,78,14584,78,56256,156,normal,-
8455459733832255076,10.0.2.16,62.109.141.196,443,tcp,tls,109364,29772,66,11814,58,41586,124,normal,-
694839480337593370,10.0.2.16,142.251.36.144,443,tcp,tls,341130,12024,34,3830,36,15854,70,normal,-
7014422309568239297,10.0.2.16,140.82.113.25,443,tcp,tls,9306,9408,36,6080,32,15488,68,normal,-
518861800886375260,10.0.2.16,104.18.27.93,443,udp,-,38628,365004,379,83690,196,448694,575,normal,-
6924010047985563634,10.0.2.16,104.64.122.9,443,tcp,tls,261108,632524,664,148564,416,781088,1080,normal,-
8329475506447560968,10.0.2.16,104.21.235.46,80,tcp,-,117710,2802,22,1751,25,4553,47,normal,-
4521588990595459023,10.0.2.16,77.75.79.234,443,tcp,tls,388572,16006,48,5626,48,21632,96,normal,-
8303900535665991229,10.0.2.16,142.250.27.155,443,udp,-,15418,7285,15,5380,11,12665,26,normal,-
-3885992193848871177,10.0.2.16,93.184.221.225,443,tcp,tls,360918,2345506,1782,82204,1302,2427710,3084,normal,-
2580847504360855055,10.0.2.16,3.127.110.207,443,tcp,tls,231580,14064,50,5134,52,19198,102,normal,-
6541527582459498623,10.0.2.16,142.250.27.156,443,tcp,tls,341336,13976,44,5466,46,19442,90,normal,-
-5408316954372942834,10.0.2.16,188.185.87.101,443,tcp,tls,355707,1014368,818,55894,676,1070262,1494,normal,-
-2719348115818198787,10.0.2.16,137.138.6.97,443,tcp,tls,145473,516848,396,16281,214,533129,610,normal,-
1112833200854555159,10.0.2.16,104.16.182.15,443,tcp,tls,124395,14559,50,10015,50,24574,100,normal,-
-4380072578270913210,10.0.2.16,188.185.35.172,443,tcp,tls,1147,79240,78,6992,63,86232,141,normal,-
-4489659634947304933,10.0.2.16,18.198.5.220,443,tcp,tls,206522,1738320,1368,67254,774,1805574,2142,normal,-
-7829526791670848807,10.0.2.16,188.185.125.217,443,tcp,tls,597190,933881,803,44880,545,978761,1348,normal,-
9097571944920492134,10.0.2.16,188.185.27.152,443,tcp,tls,113861,588031,469,28101,373,616132,842,normal,-
6149752877249959259,10.0.2.16,172.67.72.172,443,tcp,tls,98078,12890,30,3916,30,16806,60,normal,-
1461483094560582470,10.0.2.16,104.19.188.97,443,tcp,tls,468727,173046,172,10790,120,183836,292,normal,-
-7261269060471462632,10.0.2.16,188.184.21.108,80,tcp,http,9114,3284,8,1388,10,4672,18,normal,-
4897590698145977242,10.0.2.16,104.244.42.3,443,tcp,tls,241664,14581,56,7602,54,22183,110,normal,-
-4913501100266922537,10.0.2.16,34.232.31.155,443,tcp,tls,187630,18918,59,7771,59,26689,118,normal,-
-7438914945915122332,10.0.2.16,205.185.208.79,443,tcp,tls,344338,52890,78,6848,76,59738,154,normal,-
-4936068227012310528,10.0.2.16,52.43.61.251,443,tcp,tls,954376,9054,34,4818,32,13872,66,normal,-
-5940954721273900315,10.0.2.16,54.205.105.217,443,tcp,tls,72815,19916,47,6014,48,25930,95,normal,-
-8295811331814157445,10.0.2.16,142.250.102.155,443,tcp,tls,240034,12694,38,3938,38,16632,76,normal,-
8759926038733989282,10.0.2.16,104.21.235.45,443,tcp,tls,590,16516,36,4328,34,20844,70,normal,-
-6526049918812996240,10.0.2.16,54.85.188.7,443,tcp,tls,102175,37588,95,20775,95,58363,190,normal,-
-9160588071443931351,10.0.2.16,18.66.97.81,443,tcp,tls,240368,16954,42,4804,42,21758,84,normal,-
-8483142514608691556,10.0.2.16,104.96.92.79,443,tcp,tls,240534,15500,48,5138,46,20638,94,normal,-
6671041354667460281,10.0.2.16,104.16.181.15,443,tcp,tls,126468,1111063,964,56676,648,1167739,1612,normal,-
2277304747910550746,10.0.2.16,151.101.1.69,443,tcp,tls,320398,719760,618,31572,358,751332,976,normal,-
5477571941582524422,10.0.2.16,104.21.235.46,443,tcp,tls,326,12794,24,2920,24,15714,48,normal,-
1357282943278228212,10.0.2.16,23.195.248.158,443,tcp,tls,240948,101772,121,9042,88,110814,209,normal,-
6091166179911415097,10.0.2.16,140.82.121.6,443,tcp,tls,413160,93108,436,300638,426,393746,862,normal,-
9094449956484330752,10.0.2.16,91.228.74.159,443,tcp,tls,450,8846,22,2898,22,11744,44,normal,-
-5010479453521280095,10.0.2.16,140.82.121.3,443,tcp,tls,340158,1982196,1618,110212,1058,2092408,2676,normal,-
8622298552076700261,10.0.2.16,77.75.77.235,443,tcp,tls,389552,14578,46,5368,46,19946,92,normal,-
-2580620637312483816,10.0.2.16,99.84.155.41,443,tcp,tls,279128,19024,62,9884,64,28908,126,normal,-
-5652232835339283725,10.0.2.16,91.228.74.251,443,tcp,tls,62493,34087,57,6346,53,40433,110,normal,-
3500610564135599526,10.0.2.16,140.82.114.22,443,tcp,tls,336820,23002,106,25298,90,48300,196,normal,-
-2715842158285761967,10.0.2.16,162.159.153.247,443,tcp,tls,1078,14276,32,4072,32,18348,64,normal,-
2978362480804012003,10.0.2.16,5.101.109.44,443,tcp,tls,101102,9468,32,4276,34,13744,66,normal,-
4444961816039437320,10.0.2.16,140.82.112.26,443,tcp,tls,164320,12212,66,13400,64,25612,130,normal,-
2964579258975529265,10.0.2.16,104.17.72.206,443,tcp,tls,248568,9642,38,6000,36,15642,74,normal,-
1665331696877108857,10.0.2.16,151.101.192.233,443,tcp,tls,248190,13286,44,6210,40,19496,84,normal,-
9071608197164957855,10.0.2.16,104.17.25.14,443,tcp,tls,1356,46124,56,4382,38,50506,94,normal,-
-6586146335355473684,10.0.2.16,104.16.86.20,443,tcp,tls,3606,261354,210,7994,100,269348,310,normal,-
6662345114428935966,10.0.2.16,162.243.189.2,443,tcp,tls,102118,25474,46,4314,36,29788,82,normal,-
-1776143151124040255,10.0.2.16,172.64.144.98,443,tcp,tls,311102,19274,73,23314,73,42588,146,normal,-
4723824338181306085,10.0.2.16,185.14.184.154,443,tcp,tls,344162,60138,74,6394,74,66532,148,normal,-
-2607392391884383843,10.0.2.16,18.64.79.54,443,tcp,tls,247268,54152,72,5990,58,60142,130,normal,-
-1727068171893968749,10.0.2.16,18.66.2.15,443,tcp,tls,244708,295070,234,8944,120,304014,354,normal,-
-7461062859621535688,10.0.2.16,104.18.9.135,443,udp,-,46604,435266,432,36672,175,471938,607,normal,-
7640164499460229829,10.0.2.16,35.232.111.17,80,tcp,http,696,884,10,754,10,1638,20,normal,-
-4925809919344988044,10.0.2.16,104.16.86.20,443,udp,-,532,10704,20,3666,10,14370,30,normal,-
-5659100546189103508,10.0.2.16,142.251.36.102,443,udp,-,910,33879,48,12037,40,45916,88,normal,-
2355175896348079010,10.0.2.16,142.251.36.144,443,udp,-,762,17516,22,4948,20,22464,42,normal,-
-8434661483865477734,10.0.2.16,34.223.124.45,80,tcp,http,12076,6104,20,3336,18,9440,38,normal,-
-571296703253551304,10.0.2.16,104.18.214.59,443,udp,-,26324,53397,67,15614,56,69011,123,normal,-
-8026481618965076694,10.0.2.16,104.21.235.45,443,udp,-,14366,893968,798,38434,188,932402,986,normal,-
5357923482286085416,10.0.2.16,142.251.36.74,443,udp,-,2640,401732,361,26987,144,428719,505,normal,-
-7714799460534108121,10.0.2.16,104.17.25.14,443,udp,-,2290,138310,126,8754,64,147064,190,normal,-
-6769346223475653584,10.0.2.16,188.185.35.172,80,tcp,http,111394,1462,20,2054,22,3516,42,normal,-
-1055505742275276327,10.0.2.16,162.159.153.247,443,udp,-,516,15592,24,3860,12,19452,36,normal,-
285879769179302174,10.0.2.16,39.156.66.10,80,tcp,-,11262,360,6,472,8,832,14,normal,-
4489615899126950537,10.0.2.16,188.185.87.101,80,tcp,http,9468,864,10,1370,10,2234,20,normal,-
8527822574052759363,10.0.2.27,224.0.0.251,5353,udp,-,0,0,0,1281,7,1281,7,normal,-
-5210584450158560004,10.0.2.27,18.64.103.119,443,tcp,tls,171534,20106,52,5262,46,25368,98,normal,-
4844037722583206170,10.0.2.27,77.75.76.30,443,tcp,tls,534629,327284,471,76836,384,404120,855,normal,-
-3671431940251609852,10.0.2.27,77.75.78.54,443,tcp,-,3458,1702,8,1319,13,3021,21,normal,-
-3426901735209061941,10.0.2.27,77.75.78.101,443,tcp,tls,264455,37910,106,15659,103,53569,209,normal,-
1704372504750297675,10.0.2.27,77.75.77.195,443,tcp,tls,359431,778060,820,58168,670,836228,1490,normal,-
-3363978210370990513,10.0.2.27,34.120.208.123,443,tcp,tls,1156624,91431,535,156250,460,247681,995,normal,-
-694398557694368680,10.0.2.27,17.253.73.205,80,tcp,-,103739,3334,21,1743,23,5077,44,normal,-
-4276875668474932326,10.0.2.27,77.75.79.195,443,tcp,tls,873716,1800298,1675,100826,1330,1901124,3005,normal,-
2995437536823675541,10.0.2.27,77.75.78.196,443,tcp,-,701015,179706,321,51605,285,231311,606,normal,-
2462589392247834957,10.0.2.27,23.195.248.26,443,tcp,tls,419455,2723908,2040,101023,1598,2824931,3638,normal,-
-1165333644226170667,10.0.2.27,142.251.36.138,443,tcp,tls,48509,132588,681,111699,660,244287,1341,normal,-
1139097529868269489,10.0.2.27,77.75.76.104,443,tcp,tls,95382,82300,158,19174,140,101474,298,normal,-
-6819762712485572130,10.0.2.27,185.89.210.20,443,tcp,tls,22794,11642,28,4894,24,16536,52,normal,-
6386872622500734427,10.0.2.27,77.75.78.36,443,tcp,tls,344943,51546,126,17282,125,68828,251,normal,-
-2112472997177305620,10.0.2.27,141.95.47.54,443,tcp,tls,189751,57056,102,10407,88,67463,190,normal,-
-8711265168897239914,10.0.2.27,95.100.146.66,80,tcp,-,1231477,47748,225,29481,236,77229,461,normal,-
2831106026518675287,10.0.2.27,77.75.78.104,443,tcp,tls,46407,61787,101,17931,104,79718,205,normal,-
-3864228661529094252,10.0.2.27,151.101.1.69,443,tcp,tls,175826,106920,242,25287,212,132207,454,normal,-
4115297145135436483,10.0.2.27,23.195.248.219,443,tcp,tls,550970,6419516,4611,138439,2195,6557955,6806,normal,-
-279225702905615462,10.0.2.27,142.251.36.67,80,tcp,http,949781,24197,160,18274,169,42471,329,normal,-
9122648419066399891,10.0.2.27,146.59.30.96,443,tcp,-,386,120,2,256,4,376,6,normal,-
2711755706606797802,10.0.2.27,34.107.221.82,80,tcp,http,834369,8510,107,8414,110,16924,217,normal,-
1822369280641772886,10.0.2.27,77.75.78.20,443,tcp,tls,857168,44912,149,57993,144,102905,293,normal,-
1937297746788005592,10.0.2.27,212.56.133.81,443,tcp,tls,2090,12482,40,4802,40,17284,80,normal,-
844280501760026788,10.0.2.27,77.75.76.209,443,tcp,tls,77288,176550,163,9215,105,185765,268,normal,-
-1507996746295574838,10.0.2.27,198.47.127.20,443,tcp,tls,341398,12930,42,5206,40,18136,82,normal,-
-3087307793319428222,10.0.2.27,77.75.79.129,443,tcp,tls,513777,21276,63,7275,65,28551,128,normal,-
4262532112177168359,10.0.2.27,41.216.83.81,443,tcp,tls,4744,16042,43,5147,39,21189,82,normal,-
1523000221071776371,10.0.2.27,15.236.117.205,443,tcp,tls,64538,14262,40,7222,38,21484,78,normal,-
-6744507726765354919,10.0.2.27,185.64.190.78,443,tcp,tls,343022,12274,42,4944,42,17218,84,normal,-
3048915347357821107,10.0.2.27,142.251.36.130,443,tcp,tls,890021,88710,185,20335,173,109045,358,normal,-
-53446619374516341,10.0.2.27,34.117.237.239,443,tcp,tls,789744,23585,94,10305,95,33890,189,normal,-
6529275603687814339,10.0.2.27,104.18.32.68,80,tcp,http,1070706,23470,164,15868,178,39338,342,normal,-
1974157738736637653,10.0.2.27,31.30.189.76,443,tcp,tls,17861,16632,30,3657,33,20289,63,normal,-
953915309116823493,10.0.2.27,77.75.79.234,443,tcp,tls,170903,40678,55,4518,39,45196,94,normal,-
-8718978889608820892,10.0.2.27,192.229.221.95,80,tcp,http,2530473,84661,438,58332,454,142993,892,normal,-
1401803625952588021,10.0.2.27,142.251.36.65,443,tcp,tls,171398,29592,48,5159,48,34751,96,normal,-
7086311611449757061,10.0.2.27,157.240.30.3,443,tcp,tls,27561,34721,318,130943,268,165664,586,normal,-
-6014919578341045408,10.0.2.27,35.224.170.84,80,tcp,http,822,884,10,754,10,1638,20,normal,-
-7863133239084132998,10.0.2.27,157.240.30.18,443,tcp,tls,152889,123909,319,35937,275,159846,594,normal,-
8832748876643128215,10.0.2.27,8.8.8.8,53,udp,dns,5769877,398928,2428,222793,2435,621721,4863,normal,-
-7415774022266785431,10.0.2.27,142.251.37.110,443,tcp,tls,1415802,370605,627,69399,562,440004,1189,normal,-
-2275240576872421709,10.0.2.27,142.251.37.98,443,tcp,tls,631039,166498,286,29671,256,196169,542,normal,-
-382155680346777747,10.0.2.27,142.251.36.132,443,tcp,tls,1227558,423468,569,52445,536,475913,1105,normal,-
-5755437606256299791,10.0.2.27,142.251.37.110,443,udp,-,322270,2279113,2581,914998,1882,3194111,4463,normal,-
4608732527779521533,10.0.2.27,23.195.248.208,443,tcp,tls,317499,25590,66,7615,56,33205,122,normal,-
4638133225203384927,10.0.2.27,142.251.36.98,443,udp,-,106341,111414,264,59793,203,171207,467,normal,-
2083226548088625295,10.0.2.27,77.75.78.157,443,tcp,tls,522541,26463,82,9229,82,35692,164,normal,-
-3858945911454779189,10.0.2.27,142.251.37.99,443,tcp,tls,616067,690898,688,43519,459,734417,1147,normal,-
6996104190188828276,10.0.2.27,31.30.189.12,443,tcp,tls,28821,27720,50,6095,55,33815,105,normal,-
-4650093668190508959,10.0.2.27,31.13.72.12,443,tcp,tls,2244,20760,57,6762,50,27522,107,normal,-
-1173783088214379943,10.0.2.27,157.240.30.35,443,tcp,tls,136088,1146708,1062,72263,1004,1218971,2066,normal,-
-5712658470404758510,10.0.2.27,142.251.37.106,443,tcp,tls,276009,107375,173,18297,155,125672,328,normal,-
-5920778378885515181,10.0.2.27,141.95.47.56,443,tcp,tls,202572,27344,62,7428,58,34772,120,normal,-
5764252163196217418,10.0.2.27,158.194.230.160,443,tcp,-,299581,1992116,1646,114730,1112,2106846,2758,normal,-
-4966700536721626637,10.0.2.27,147.229.2.90,443,tcp,tls,39807,1182678,911,44938,572,1227616,1483,normal,-
-614904160861936069,10.0.2.27,142.251.37.98,443,udp,-,210305,371003,509,103895,317,474898,826,normal,-
-5820144129389292443,10.0.2.27,142.251.36.78,443,tcp,tls,158433,382179,381,25183,254,407362,635,normal,-
2977796809192899287,10.0.2.27,142.251.36.98,443,tcp,tls,477988,78802,215,24854,204,103656,419,normal,-
-3999097524952947523,10.0.2.27,142.251.36.118,443,tcp,tls,512839,19695,57,6015,59,25710,116,normal,-
1278180735663707893,10.0.2.27,142.251.36.132,443,udp,-,433730,8505975,8845,1473711,4547,9979686,13392,normal,-
-3304622155453605556,10.0.2.27,91.151.132.18,443,tcp,tls,1658,12264,40,4618,36,16882,76,normal,-
3268595052101571029,10.0.2.27,157.240.221.16,443,tcp,tls,1381,19372,54,6607,49,25979,103,normal,-
2592171471469086026,10.0.2.27,77.75.78.93,443,tcp,tls,342316,14784,48,5386,48,20170,96,normal,-
-5103867154995383501,10.0.2.27,31.30.189.78,443,tcp,tls,348087,233533,216,15760,175,249293,391,normal,-
8282908681636672321,10.0.2.27,142.251.36.97,443,tcp,tls,349112,254663,359,34560,327,289223,686,normal,-
8883021626569446220,10.0.2.27,217.75.217.17,443,tcp,tls,2300,12440,38,4588,36,17028,74,normal,-
-8516822140395023193,10.0.2.27,142.251.36.67,443,udp,-,145384,189535,412,103946,352,293481,764,normal,-
4520065868836101264,10.0.2.27,147.229.9.226,443,tcp,tls,232727,159426,352,46961,343,206387,695,normal,-
4063621187279380084,10.0.2.27,147.229.71.28,443,tcp,tls,270538,2720754,2063,144101,1690,2864855,3753,normal,-
-6391990124206090700,10.0.2.27,77.75.77.222,443,tcp,tls,521249,388646,396,35999,293,424645,689,normal,-
5323278457219510028,10.0.2.27,64.210.135.119,443,tcp,tls,16706,79194,116,10534,84,89728,200,normal,-
-2198609495444293549,10.0.2.27,142.251.37.99,443,udp,-,52848,218382,235,41040,166,259422,401,normal,-
-5944442102773608995,10.0.2.27,64.210.135.112,443,tcp,tls,30762,394948,296,16360,256,411308,552,normal,-
-2596035573758407294,10.0.2.27,17.253.144.10,443,tcp,tls,664,17599,34,4938,35,22537,69,normal,-
3948544016531927334,10.0.2.27,142.251.36.99,80,tcp,-,1401611,46179,246,33434,257,79613,503,normal,-
3840077232738661486,10.0.2.27,205.185.208.142,443,tcp,tls,82238,207449,221,15654,154,223103,375,normal,-
-4459130352222371830,10.0.2.27,142.251.36.142,443,udp,-,181934,3413129,3068,541227,1499,3954356,4567,normal,-
-5187516682969983803,10.0.2.27,142.251.36.86,443,tcp,tls,76853,136222,200,19264,170,155486,370,normal,-
-2681635795840106027,10.0.2.27,87.240.129.133,443,tcp,-,148,120,2,256,4,376,6,normal,-
-2417808179953103951,10.0.2.27,142.251.36.134,443,tcp,tls,342544,12582,36,3938,38,16520,74,normal,-
8086241701382885733,10.0.2.27,66.254.114.156,443,tcp,tls,10962,8522,24,2546,24,11068,48,normal,-
-8069697809682144733,10.0.2.27,77.75.79.165,443,tcp,tls,513594,21858,70,8483,71,30341,141,normal,-
-9201981088319063875,10.0.2.27,157.240.247.8,443,tcp,tls,822,14232,42,4608,36,18840,78,normal,-
-707078218765749903,10.0.2.27,13.107.42.14,443,tcp,tls,345002,177657,336,73029,313,250686,649,normal,-
7947339597227736349,10.0.2.27,216.239.32.36,443,udp,-,50261,41474,87,24789,68,66263,155,normal,-
6287003181217250709,10.0.2.27,216.239.32.36,443,tcp,tls,512809,28219,92,11555,90,39774,182,normal,-
-4898698335495736483,10.0.2.27,18.66.2.31,443,tcp,tls,177503,52057,71,6107,59,58164,130,normal,-
2988065713392083984,10.0.2.27,157.240.30.27,443,udp,-,82306,3629119,3121,136415,1120,3765534,4241,normal,-
-1896838202333909107,10.0.2.27,142.250.27.157,443,tcp,tls,814,13454,38,4636,36,18090,74,normal,-
-3443530738984897861,10.0.2.27,31.30.189.78,443,udp,-,2972,1877764,1366,47592,462,1925356,1828,normal,-
-757471763942618311,10.0.2.27,142.251.36.134,443,udp,-,1067,17866,24,6359,21,24225,45,normal,-
-8503498976062393655,10.0.2.27,142.251.36.97,443,udp,-,80445,1332222,1139,113721,535,1445943,1674,normal,-
3913125386095573251,10.0.2.27,23.195.249.173,443,tcp,tls,204115,134206,200,19765,163,153971,363,normal,-
3634494154747123293,10.0.2.27,31.30.189.76,443,udp,-,5426,4196256,3050,88906,910,4285162,3960,normal,-
1096640451666890788,10.0.2.27,142.251.36.99,443,tcp,tls,1192154,97313,227,23854,215,121167,442,normal,-
5318273318284541399,10.0.2.27,104.18.20.226,80,tcp,-,264093,12639,53,5370,57,18009,110,normal,-
7476524248384273925,10.0.2.27,142.251.36.150,443,tcp,tls,19973,26208,56,6969,57,33177,113,normal,-
-359484602941081536,10.0.2.27,142.251.36.74,443,tcp,tls,565602,126059,234,27780,209,153839,443,normal,-
8039158494202685723,10.0.2.27,204.79.197.203,443,tcp,tls,58308,14154,32,3702,32,17856,64,normal,-
3597634162798491232,10.0.2.27,212.56.133.81,443,udp,-,524,18502,26,3988,14,22490,40,normal,-
2807237111346991265,10.0.2.27,151.101.193.21,443,tcp,tls,245336,27632,63,7105,58,34737,121,normal,-
-3247319793816644404,10.0.2.27,216.18.168.30,443,tcp,tls,10364,10132,20,2438,22,12570,42,normal,-
5922868528187653999,10.0.2.27,41.216.83.81,443,udp,-,1300,18468,26,4076,14,22544,40,normal,-
5020221522264927747,10.0.2.27,31.30.189.145,443,tcp,tls,525606,643204,595,35516,362,678720,957,normal,-
8269585517304042783,10.0.2.27,142.251.36.67,443,tcp,tls,416135,98353,280,32785,256,131138,536,normal,-
8465791598416603990,10.0.2.27,95.100.146.16,443,tcp,tls,269381,239853,245,18767,182,258620,427,normal,-
-6068379230675019372,10.0.2.27,195.12.177.81,443,tcp,tls,340794,9346,40,3938,38,13284,78,normal,-
8656440606199313916,10.0.2.27,31.30.189.12,443,udp,-,6266,7394308,5322,132898,1462,7527206,6784,normal,-
8357563327305663851,10.0.2.27,192.124.249.36,80,tcp,http,266638,24261,63,7351,65,31612,128,normal,-
6689210839303308207,10.0.2.27,23.195.248.72,443,tcp,tls,123715,1464191,1049,40025,664,1504216,1713,normal,-
-5265007027450116329,10.0.2.27,66.254.114.41,443,tcp,tls,93833,147620,156,11628,104,159248,260,normal,-
-4216782389098397593,10.0.2.27,104.16.56.101,443,tcp,tls,168535,17007,47,5507,44,22514,91,normal,-
-412630685803978527,10.0.2.27,186.192.90.12,443,tcp,tls,66282,19141,47,5758,49,24899,96,normal,-
-3129086808502983768,10.0.2.27,104.17.49.95,443,tcp,tls,133619,31364,101,14889,101,46253,202,normal,-
-3933358169415870238,10.0.2.27,185.152.64.17,443,tcp,-,282,120,2,256,4,376,6,normal,-
9016877423589889517,10.0.2.27,18.66.0.143,443,tcp,tls,186554,3376374,2650,107725,1330,3484099,3980,normal,-
562623830931137688,10.0.2.27,87.248.119.251,443,tcp,tls,417907,934539,875,59792,571,994331,1446,normal,-
-4577878577441127492,10.0.2.27,91.198.174.192,443,tcp,tls,158851,40385,103,11796,96,52181,199,normal,-
-2338761108942461883,10.0.2.27,142.251.36.118,443,udp,-,18265,1829624,1415,57035,501,1886659,1916,normal,-
-7204189254175568864,10.0.2.27,18.66.8.8,443,tcp,tls,70319,182650,174,12557,139,195207,313,normal,-
-8924171382942279590,10.0.2.27,95.100.146.34,443,tcp,tls,119694,24314,74,7488,72,31802,146,normal,-
-5394853344096944703,10.0.2.27,99.86.3.97,443,tcp,tls,396489,771389,649,37102,463,808491,1112,normal,-
2420452043535874516,10.0.2.27,99.84.146.129,443,tcp,tls,119086,17878,50,5850,44,23728,94,normal,-
-5110899430147625015,10.0.2.27,18.64.100.43,443,tcp,tls,44084,36577,84,10037,92,46614,176,normal,-
4610093965345091327,10.0.2.27,34.107.204.85,443,tcp,tls,231507,32480,86,11525,91,44005,177,normal,-
2574850898711582495,10.0.2.27,13.107.21.200,443,tcp,-,573054,51921,189,28130,190,80051,379,normal,-
7047306785986040277,10.0.2.27,147.92.243.206,443,tcp,tls,104711,40978,82,8975,84,49953,166,normal,-
-3474429193189713754,10.0.2.27,204.79.197.212,443,tcp,tls,207481,16310,43,5244,42,21554,85,normal,-
4852219159541157965,10.0.2.27,142.250.102.155,443,tcp,tls,16946,12084,30,3350,30,15434,60,normal,-
-7903386031129619756,10.0.2.27,217.75.217.17,443,udp,-,1786,23924,34,9830,18,33754,52,normal,-
3122041480945943516,10.0.2.27,104.17.69.176,443,tcp,tls,115004,53434,68,5350,48,58784,116,normal,-
8214861776471059323,10.0.2.27,142.251.36.81,443,tcp,tls,39220,13306,30,3458,32,16764,62,normal,-
-302622442215362452,10.0.2.27,149.154.167.99,443,tcp,tls,95360,14386,32,3598,34,17984,66,normal,-
6124050254099984107,10.0.2.27,52.97.188.66,443,tcp,tls,916,94022,90,5340,54,99362,144,normal,-
-3901109196953889633,10.0.2.27,35.157.246.167,443,tcp,tls,73193,31573,78,12269,75,43842,153,normal,-
1300851813069404104,10.0.2.27,142.251.36.74,443,udp,-,9193,173461,200,38251,133,211712,333,normal,-
-3804186864551608503,10.0.2.27,104.18.17.182,443,tcp,tls,2240,12842,32,4220,34,17062,66,normal,-
-8024652532761795941,10.0.2.27,142.251.36.106,443,tcp,tls,248048,558705,556,38068,354,596773,910,normal,-
-8024680393031465139,10.0.2.27,185.89.211.84,443,tcp,tls,22330,11670,28,5219,27,16889,55,normal,-
6674990891499754882,10.0.2.27,156.40.212.210,443,tcp,tls,168166,28334,66,7348,70,35682,136,normal,-
5441875117375671599,10.0.2.27,87.248.119.252,443,tcp,tls,1064,33128,69,7570,65,40698,134,normal,-
-303729243200998282,10.0.2.27,18.156.0.31,443,tcp,tls,33537,42086,63,9427,54,51513,117,normal,-
8617395511108519051,10.0.2.27,66.254.114.38,443,tcp,tls,61100,28473,61,8394,55,36867,116,normal,-
8432959482298338194,10.0.2.27,104.16.57.101,443,tcp,tls,487275,33068,128,30581,125,63649,253,normal,-
-4182176473125730781,10.0.2.27,104.16.124.96,443,tcp,tls,3514,188780,169,11883,119,200663,288,normal,-
4007735480177004526,10.0.2.27,104.19.188.97,443,tcp,tls,749861,226924,277,22723,232,249647,509,normal,-
-5546784418325008188,10.0.2.27,151.101.129.69,443,tcp,tls,342392,155008,214,16550,152,171558,366,normal,-
2892081505880330828,10.0.2.27,18.203.33.237,443,tcp,tls,317212,21292,72,9678,69,30970,141,normal,-
3529813149838537273,10.0.2.27,104.17.234.204,443,tcp,tls,114170,13152,56,6462,56,19614,112,normal,-
3062140041963073661,10.0.2.27,142.251.36.65,443,udp,-,27424,673088,509,23838,196,696926,705,normal,-
-6119466768232857470,10.0.2.27,142.251.36.142,443,tcp,tls,641062,166958,300,33769,293,200727,593,normal,-
2401610538477062030,10.0.2.27,199.232.196.124,443,tcp,tls,183352,459905,425,27829,282,487734,707,normal,-
-1657099550939100417,10.0.2.27,104.18.22.41,443,tcp,-,85975,40440,121,16415,126,56855,247,normal,-
-1780918774481845676,10.0.2.27,52.35.165.153,443,tcp,tls,92484,32890,131,43539,127,76429,258,normal,-
6185795766529734328,10.0.2.27,18.64.84.37,80,tcp,http,67644,2964,16,1878,18,4842,34,normal,-
-8966838436214666372,10.0.2.27,151.101.194.137,443,tcp,tls,174076,368061,318,17575,212,385636,530,normal,-
-5321901934360361455,10.0.2.27,104.18.167.224,443,tcp,tls,83816,55089,77,6666,65,61755,142,normal,-
-4159807713378806803,10.0.2.27,142.251.36.78,443,udp,-,88335,1320257,1246,272632,701,1592889,1947,normal,-
-6070702856602339110,10.0.2.27,70.42.32.223,443,tcp,tls,22790,13701,39,6709,36,20410,75,normal,-
5359126005451714193,10.0.2.27,200.147.3.157,443,tcp,tls,59045,13152,36,5269,38,18421,74,normal,-
-5166118939315762749,10.0.2.27,151.101.193.26,443,tcp,tls,365455,18834,52,5505,51,24339,103,normal,-
5745848515408851306,10.0.2.27,91.189.91.157,123,udp,ntp,948,540,6,540,6,1080,12,normal,-
7778516944458632724,10.0.2.27,35.241.9.51,443,tcp,tls,3358,12742,30,4210,32,16952,62,normal,-
8736813504344900864,10.0.2.27,64.210.135.114,443,tcp,tls,526,8932,26,2964,22,11896,48,normal,-
-4052322054394272870,10.0.2.27,142.251.37.106,443,udp,-,19946,215187,219,30184,131,245371,350,normal,-
8270365724618001302,10.0.2.27,34.111.9.237,443,tcp,tls,1320,31042,46,4526,40,35568,86,normal,-
-7877189358536618266,10.0.2.27,216.239.34.36,443,tcp,tls,230520,30228,103,13989,101,44217,204,normal,-
-4431060402353168205,10.0.2.27,188.65.124.92,443,tcp,tls,92069,17392,45,5780,45,23172,90,normal,-
-2174487217388392050,10.0.2.27,162.159.138.60,443,tcp,tls,11412,6868,18,2330,20,9198,38,normal,-
6329893001950302005,10.0.2.27,142.251.36.129,443,tcp,tls,5338,35013,77,8445,67,43458,144,normal,-
-3426824069228035679,10.0.2.27,198.47.127.18,443,tcp,tls,137871,24168,64,12341,61,36509,125,normal,-
4709251763368306747,10.0.2.27,142.251.36.130,443,udp,-,40401,110109,136,27790,96,137899,232,normal,-
-3526694111287387377,10.0.2.27,192.229.221.24,443,tcp,tls,137513,17709,53,5579,47,23288,100,normal,-
4002282094125753856,10.0.2.27,18.66.2.126,443,tcp,tls,117734,15794,36,4228,34,20022,70,normal,-
-8511709907140191532,10.0.2.27,146.75.118.132,443,tcp,tls,18816,62378,68,5006,48,67384,116,normal,-
8348989617131680398,10.0.2.27,140.82.121.4,443,tcp,tls,30478,7916,30,3134,26,11050,56,normal,-
-5547383398928970507,10.0.2.27,104.17.113.188,443,tcp,tls,452571,22098,77,8790,75,30888,152,normal,-
702511752335133142,10.0.2.27,34.120.133.55,443,tcp,tls,672,16262,38,4408,36,20670,74,normal,-
7581106597707199449,10.0.2.27,34.107.254.252,443,tcp,tls,89062,25743,65,7574,65,33317,130,normal,-
7649720280563851985,10.0.2.27,142.251.36.131,443,tcp,tls,142271,376555,309,20765,181,397320,490,normal,-
195136168588415849,10.0.2.27,151.101.193.91,443,tcp,tls,11814,775696,587,22893,318,798589,905,normal,-
542609441933620692,10.0.2.27,95.100.146.59,443,tcp,tls,68277,1780215,1359,76056,814,1856271,2173,normal,-
1912629482212172205,10.0.2.27,23.64.52.128,443,tcp,tls,155750,33156,62,6296,58,39452,120,normal,-
6118093765340154849,10.0.2.27,213.19.162.31,443,tcp,tls,42687,34035,96,19497,90,53532,186,normal,-
-227753756334737361,10.0.2.27,23.195.249.96,443,tcp,tls,81462,255590,229,12163,140,267753,369,normal,-
-6574691226159465844,10.0.2.27,18.64.103.63,443,tcp,tls,173112,98974,94,5654,62,104628,156,normal,-
7477784346193151037,10.0.2.27,52.28.203.152,443,tcp,tls,179880,34850,113,22491,115,57341,228,normal,-
-7837348073153608390,10.0.2.27,18.64.99.47,443,tcp,tls,175724,22522,42,4688,42,27210,84,normal,-
-8868050525802163058,10.0.2.27,18.64.103.92,443,tcp,tls,389823,25366,68,8675,65,34041,133,normal,-
4025554257779258985,10.0.2.27,18.64.119.3,443,tcp,tls,176760,105958,102,5166,58,111124,160,normal,-
7467351514850858834,10.0.2.27,34.149.12.213,443,tcp,tls,26652,36119,92,19239,95,55358,187,normal,-
-5366294779452895755,10.0.2.27,104.17.214.204,443,tcp,tls,113834,12752,44,5048,42,17800,86,normal,-
2700715307322464588,10.0.2.27,18.64.103.94,443,tcp,tls,389874,49367,90,11882,86,61249,176,normal,-
1763508293113553917,10.0.2.27,104.244.42.197,443,tcp,tls,172416,9520,36,4752,34,14272,70,normal,-
5481275036511476400,10.0.2.27,87.248.100.216,443,tcp,tls,280110,937104,767,51768,540,988872,1307,normal,-
4506242527070232939,10.0.2.27,34.201.195.249,443,tcp,tls,166834,16442,46,5774,44,22216,90,normal,-
794795812408933298,10.0.2.27,142.251.37.102,443,tcp,tls,3603,63149,98,9544,91,72693,189,normal,-
-6843508407324623704,10.0.2.27,13.37.25.97,443,tcp,tls,95123,32114,117,40751,112,72865,229,normal,-
-1883318228335157595,10.0.2.27,146.75.120.157,443,tcp,tls,174148,44430,64,4838,44,49268,108,normal,-
-6086393843002735652,10.0.2.27,172.64.154.85,443,tcp,tls,284730,16885,51,6171,48,23056,99,normal,-
-5752089812364783016,10.0.2.27,35.163.217.60,443,tcp,tls,1259850,9646,42,5104,36,14750,78,normal,-
6348380685396468099,10.0.2.27,18.168.187.73,443,tcp,tls,89760,14767,50,8705,47,23472,97,normal,-
8673583677170827340,10.0.2.27,45.79.189.238,443,tcp,tls,1530,14902,24,3684,24,18586,48,normal,-
4469501968237514749,10.0.2.27,23.195.248.142,443,tcp,tls,156735,13697,53,5948,47,19645,100,normal,-
-8485132540129682612,10.0.2.27,54.171.39.218,443,tcp,tls,122474,13718,38,4416,38,18134,76,normal,-
-2457272930425730323,10.0.2.27,23.195.249.162,443,tcp,tls,176376,238910,223,15446,143,254356,366,normal,-
-4328985532022102432,10.0.2.27,52.54.240.100,443,tcp,tls,170558,15114,42,5304,42,20418,84,normal,-
727119286744122917,10.0.2.27,18.64.83.82,443,tcp,tls,254663,143856,143,8887,94,152743,237,normal,-
515831930541412462,10.0.2.27,18.64.100.41,443,tcp,tls,135724,664694,521,22579,307,687273,828,normal,-
-1492653461209377642,10.0.2.27,192.229.221.25,443,tcp,tls,73440,20194,40,4246,36,24440,76,normal,-
-991742323356574392,10.0.2.27,186.192.81.5,443,tcp,tls,61960,11176,32,3598,34,14774,66,normal,-
1704225659124037930,10.0.2.27,104.19.150.54,443,tcp,tls,253258,394526,309,13029,174,407555,483,normal,-
-8680041071425733994,10.0.2.27,2.16.2.209,443,tcp,tls,342982,301137,345,24414,244,325551,589,normal,-
-4122090787791050568,10.0.2.27,52.200.72.107,443,tcp,tls,12744,13288,30,4002,32,17290,62,normal,-
2231466330748917171,10.0.2.27,18.64.84.95,443,tcp,tls,290248,15762,44,4828,44,20590,88,normal,-
3986548444642795264,10.0.2.27,64.4.250.37,443,tcp,tls,60680,10440,30,4174,28,14614,58,normal,-
-2213484979395613396,10.0.2.27,18.203.174.165,443,tcp,tls,473772,33452,78,10805,78,44257,156,normal,-
5532644558518808078,10.0.2.27,104.19.154.83,443,tcp,tls,178574,17700,54,7145,54,24845,108,normal,-
-6310407070384800738,10.0.2.27,52.29.243.41,443,tcp,tls,153816,14682,70,35732,72,50414,142,normal,-
8051862221847666971,10.0.2.27,151.101.193.140,443,tcp,tls,539816,32050,121,16953,116,49003,237,normal,-
-5690961421426448694,10.0.2.27,104.26.3.70,443,tcp,tls,87473,14191,43,5157,42,19348,85,normal,-
-287323399138254833,10.0.2.27,76.223.111.18,443,tcp,tls,291402,22916,68,9352,65,32268,133,normal,-
-6680671950522071136,10.0.2.27,52.222.226.205,80,tcp,http,432143,13556,64,8008,67,21564,131,normal,-
8254091910123604825,10.0.2.27,205.185.208.20,443,tcp,tls,27233,631824,468,17297,242,649121,710,normal,-
3342973511997328806,10.0.2.27,18.64.79.112,443,tcp,tls,491849,34376,90,11120,87,45496,177,normal,-
-4693350947354427979,10.0.2.27,104.18.31.78,443,tcp,tls,1008,22924,40,4422,40,27346,80,normal,-
-8864098728508590504,10.0.2.27,142.251.37.97,443,tcp,tls,1812,201717,197,13371,138,215088,335,normal,-
-3765962430495238892,10.0.2.27,3.125.89.243,443,tcp,tls,1892,15494,30,5198,32,20692,62,normal,-
7911352927514320721,10.0.2.27,2.16.2.186,443,tcp,tls,46522,14567210,10286,195420,2883,14762630,13169,normal,-
1324555863327208899,10.0.2.27,104.96.145.246,443,tcp,tls,253852,313903,261,14726,206,328629,467,normal,-
-4223654447084205176,10.0.2.27,54.155.18.159,443,tcp,tls,36347,13720,50,9405,52,23125,102,normal,-
5019341552355405486,10.0.2.27,18.66.2.4,443,tcp,tls,1342,45592,54,6400,38,51992,92,normal,-
7591406585099716290,10.0.2.27,52.46.144.253,443,tcp,tls,364329,46941,207,171679,211,218620,418,normal,-
-5225081425469083300,10.0.2.27,151.101.1.111,443,tcp,tls,254770,21295,53,5459,51,26754,104,normal,-
198848516807813894,10.0.2.27,104.244.42.5,443,tcp,tls,382547,11229,72,11362,70,22591,142,normal,-
7405530739721521407,10.0.2.27,54.185.138.62,443,tcp,tls,124242,14156,40,4480,40,18636,80,normal,-
1612883228241348399,10.0.2.27,18.66.9.79,443,tcp,tls,292112,15762,44,4828,44,20590,88,normal,-
5677864246864913671,10.0.2.27,2.16.2.193,443,tcp,tls,490048,365269,393,26541,268,391810,661,normal,-
3848762456797630324,10.0.2.27,52.46.155.104,443,tcp,tls,235490,40768,82,13662,72,54430,154,normal,-
855747741801728041,10.0.2.27,67.220.224.144,443,tcp,tls,232132,17644,50,5676,50,23320,100,normal,-
-4018333173535104858,10.0.2.27,52.209.179.225,443,tcp,tls,169413,28734,74,9786,74,38520,148,normal,-
5608656426478574386,10.0.2.27,18.64.119.116,443,tcp,tls,166652,835558,682,33036,404,868594,1086,normal,-
-1727236453109888201,10.0.2.27,188.125.72.139,443,tcp,tls,276658,26273,93,21119,91,47392,184,normal,-
4645336092049527189,10.0.2.27,18.64.79.83,443,tcp,tls,93196,16454,38,4312,38,20766,76,normal,-
3844916966884610344,10.0.2.27,185.89.210.122,443,tcp,tls,44694,19643,53,12645,54,32288,107,normal,-
3013941672435814546,10.0.2.27,151.101.194.110,443,tcp,tls,287921,19713,61,6773,55,26486,116,normal,-
1816152901993521,10.0.2.27,34.107.222.173,443,tcp,tls,2056,20691,65,9630,61,30321,126,normal,-
802557852719164987,10.0.2.27,192.132.33.46,443,tcp,tls,61820,19194,42,4722,40,23916,82,normal,-
-1020840349461899520,10.0.2.27,54.236.162.10,443,tcp,tls,148282,15136,36,4640,38,19776,74,normal,-
8851795928307461852,10.0.2.27,52.1.81.212,443,tcp,tls,290186,14764,48,5482,50,20246,98,normal,-
3386566296583598745,10.0.2.27,52.50.220.58,443,tcp,tls,124602,20532,46,6378,40,26910,86,normal,-
4341096939174888705,10.0.2.27,52.46.128.147,443,tcp,tls,151252,17466,46,5688,44,23154,90,normal,-
-8549212035747593240,10.0.2.27,142.250.191.35,443,tcp,tls,2510,13452,46,5328,42,18780,88,normal,-
-6624824992876720270,10.0.2.27,34.117.126.186,443,tcp,tls,151948,14566,48,9338,50,23904,98,normal,-
5223794353500011062,10.0.2.27,70.42.32.95,443,tcp,tls,22980,13896,39,5966,38,19862,77,normal,-
-2039487459191199610,10.0.2.27,52.223.40.198,443,tcp,tls,170722,11426,46,5326,44,16752,90,normal,-
-2247536973296813164,10.0.2.27,172.64.144.98,443,tcp,tls,611606,20540,86,17575,86,38115,172,normal,-
7568951459136107657,10.0.2.27,130.211.23.194,443,tcp,tls,85345,18867,44,5555,46,24422,90,normal,-
222176528017820550,10.0.2.27,54.154.227.195,443,tcp,tls,174602,11230,40,6648,40,17878,80,normal,-
-3541548805590799390,10.0.2.27,104.18.25.185,443,tcp,tls,113360,10708,44,14736,44,25444,88,normal,-
-8694753556895575587,10.0.2.27,178.250.0.189,443,tcp,tls,11758,16014,44,5512,42,21526,86,normal,-
-8845445746846828090,10.0.2.27,35.156.198.41,443,tcp,tls,166836,15900,60,17136,60,33036,120,normal,-
-6983223240700650523,10.0.2.27,70.42.32.255,443,tcp,tls,15446,10066,26,6738,26,16804,52,normal,-
-7126916627950863472,10.0.2.27,185.58.74.239,443,tcp,tls,11920,9836,24,2776,24,12612,48,normal,-
1142919565577770743,10.0.2.27,72.21.195.65,443,tcp,tls,246396,24664,68,8966,67,33630,135,normal,-
4621803041149188589,10.0.2.27,142.251.36.144,443,tcp,tls,1095,23852,52,6038,48,29890,100,normal,-
8789214397656145081,10.0.2.27,18.169.227.15,443,tcp,tls,138455,6167,31,5614,33,11781,64,normal,-
-6854911752082964113,10.0.2.27,46.137.1.178,443,tcp,tls,274574,17538,56,6914,50,24452,106,normal,-
7310761938671376253,10.0.2.27,52.49.141.38,443,tcp,tls,120488,14286,36,6016,34,20302,70,normal,-
-6669437183897862954,10.0.2.27,95.100.146.43,443,tcp,tls,164048,244260,206,10604,118,254864,324,normal,-
-6760794829841784415,10.0.2.27,34.251.5.108,443,tcp,tls,1810,11820,18,2154,20,13974,38,normal,-
1931852443343524308,10.0.2.27,52.29.141.106,443,tcp,tls,168905,16653,46,8257,49,24910,95,normal,-
3417640380809048590,10.0.2.27,142.250.27.156,443,tcp,tls,19135,14741,49,6174,48,20915,97,normal,-
-2094738593753604735,10.0.2.27,34.239.58.255,443,tcp,tls,127633,28978,80,16666,76,45644,156,normal,-
-4853104232054165605,10.0.2.27,99.84.159.109,443,tcp,tls,176820,55122,64,4818,46,59940,110,normal,-
5703191091468893644,10.0.2.27,142.251.36.66,443,tcp,tls,493512,91781,179,19442,172,111223,351,normal,-
-7350078086434940442,10.0.2.27,3.225.253.25,443,tcp,tls,289968,16192,48,5488,50,21680,98,normal,-
7440155446315793754,10.0.2.27,205.185.208.79,443,tcp,tls,161004,13046,32,3428,30,16474,62,normal,-
3037440287447790378,10.0.2.27,193.189.143.34,443,tcp,tls,380788,39415,85,9315,90,48730,175,normal,-
7513091954182103600,10.0.2.27,18.64.119.75,443,tcp,tls,169496,16254,42,4624,42,20878,84,normal,-
4291242787589896631,10.0.2.27,209.197.3.25,443,tcp,tls,11784,11662,26,2792,26,14454,52,normal,-
-8689810347127030604,10.0.2.27,142.251.36.141,443,tcp,tls,95842,11656,30,3458,32,15114,62,normal,-
3407737110528198791,10.0.2.27,23.195.248.145,443,tcp,tls,701580,32187,145,19909,143,52096,288,normal,-
-4393543776710751178,10.0.2.27,151.101.193.52,443,tcp,tls,2390,65029,79,6781,58,71810,137,normal,-
6148320595282466500,10.0.2.27,2.16.2.90,443,tcp,tls,40530,750170,546,19918,280,770088,826,normal,-
7780183813614437674,10.0.2.27,152.195.34.116,443,tcp,tls,327794,226394,192,8452,110,234846,302,normal,-
-6838571615389847680,10.0.2.27,151.101.193.108,443,tcp,tls,154920,48414,66,5160,52,53574,118,normal,-
-3682588727465062240,10.0.2.27,104.18.30.78,443,tcp,tls,640,15994,32,4418,30,20412,62,normal,-
8546856322856276017,10.0.2.27,188.65.124.66,443,tcp,tls,2114,11894,16,2046,18,13940,34,normal,-
-1936387691639179333,10.0.2.27,104.18.23.41,443,tcp,tls,165068,15630,42,4462,36,20092,78,normal,-
-2156200947324966543,10.0.2.27,52.46.132.114,443,tcp,tls,238136,18178,56,11034,56,29212,112,normal,-
-5829496412613053845,10.0.2.27,157.240.20.52,443,tcp,tls,114972,8418,26,3026,24,11444,50,normal,-
4408056200531202135,10.0.2.27,104.244.42.195,443,tcp,tls,276573,15105,71,11134,70,26239,141,normal,-
-2833189534619001249,10.0.2.27,104.17.50.95,443,tcp,tls,320464,10444,42,5924,42,16368,84,normal,-
-8164400454054220150,10.0.2.27,18.64.103.106,443,tcp,tls,174442,84884,86,5466,58,90350,144,normal,-
8056515028077414352,10.0.2.27,23.195.249.193,443,tcp,tls,10655,88816,122,11575,99,100391,221,normal,-
1752286692698994801,10.0.2.27,99.83.154.140,443,tcp,tls,88887,21211,53,6359,54,27570,107,normal,-
3787408666951665418,10.0.2.27,52.94.228.167,443,tcp,tls,69546,15208,34,4018,34,19226,68,normal,-
-1243942711293667756,10.0.2.27,104.244.42.3,443,tcp,tls,170316,9596,36,4776,34,14372,70,normal,-
-6054254351454139399,10.0.2.27,54.239.28.85,443,tcp,tls,233078,15250,50,5092,50,20342,100,normal,-
5388811810621762225,10.0.2.27,52.46.141.249,443,tcp,tls,224406,15422,44,4754,42,20176,86,normal,-
1327729297381598344,10.0.2.27,157.240.30.27,443,tcp,tls,174860,317297,392,33550,323,350847,715,normal,-
-3789104136233262209,10.0.2.27,35.244.193.51,443,tcp,tls,1442,13482,38,4504,36,17986,74,normal,-
-1473722276594986322,10.0.2.27,199.232.148.157,443,tcp,tls,310196,21006,98,10547,93,31553,191,normal,-
-5277076105057746678,10.0.2.27,172.67.34.140,443,tcp,tls,252489,13133,46,5157,46,18290,92,normal,-
4944661112331892587,10.0.2.27,152.199.21.65,443,tcp,tls,274210,11778,38,3862,36,15640,74,normal,-
-459675717942712546,10.0.2.27,185.64.189.112,443,tcp,tls,56431,16967,53,12079,52,29046,105,normal,-
7932641450989594727,10.0.2.27,142.251.36.70,443,tcp,tls,2106,13736,36,4372,36,18108,72,normal,-
2975804449829952186,10.0.2.27,70.42.32.63,443,tcp,tls,15694,9380,24,3874,22,13254,46,normal,-
-7546799372414467940,10.0.2.27,146.75.122.132,443,tcp,tls,159744,47834,70,7172,52,55006,122,normal,-
-8778282150485222646,10.0.2.27,18.235.247.121,443,tcp,tls,274140,14076,44,5912,42,19988,86,normal,-
-6302208072873552844,10.0.2.27,54.208.206.200,443,tcp,tls,24476,21249,52,8561,48,29810,100,normal,-
-664598170982953323,10.0.2.27,185.89.210.101,443,tcp,tls,3032,7304,22,10946,22,18250,44,normal,-
7507827354651745408,10.0.2.27,34.194.108.116,443,tcp,tls,299528,27954,140,58176,142,86130,282,normal,-
4536269247316614370,10.0.2.27,69.173.144.139,443,tcp,tls,166601,14887,55,8005,52,22892,107,normal,-
5676391944797267904,10.0.2.27,151.101.194.132,443,tcp,tls,290378,14112,44,4780,42,18892,86,normal,-
9001820475084753456,10.0.2.27,18.64.114.28,443,tcp,tls,300226,289422,290,24118,226,313540,516,normal,-
-6593733308120458319,10.0.2.27,52.94.225.248,443,tcp,tls,231982,16124,50,6002,50,22126,100,normal,-
-5923081407419391505,10.0.2.27,18.64.94.60,443,tcp,tls,167024,21090,56,9988,56,31078,112,normal,-
8183837485355013932,10.0.2.27,104.18.11.47,443,tcp,tls,175266,42300,63,5464,50,47764,113,normal,-
856304342094548636,10.0.2.27,104.18.24.185,443,tcp,tls,169452,9992,34,5216,34,15208,68,normal,-
1970064683794988404,10.0.2.27,3.225.82.51,443,tcp,tls,1132,13064,28,3288,28,16352,56,normal,-
-4546161195806224557,10.0.2.27,44.235.246.155,443,tcp,tls,117686,12498,34,4122,34,16620,68,normal,-
-5937968584026190268,10.0.2.27,74.6.143.26,443,tcp,tls,282056,13122,40,5890,38,19012,78,normal,-
-7726079372462815498,10.0.2.27,152.195.51.15,443,tcp,tls,273770,11820,38,3862,36,15682,74,normal,-
7121467501182991723,10.0.2.27,104.96.146.246,443,tcp,tls,163278,47940,62,5412,56,53352,118,normal,-
-831762173070132645,10.0.2.27,134.122.57.34,443,tcp,tls,4706,15364,28,3642,28,19006,56,normal,-
3946458894281091636,10.0.2.27,104.26.6.139,443,tcp,tls,172630,35614,52,4506,40,40120,92,normal,-
1436735887330307881,10.0.2.27,142.251.36.72,443,tcp,tls,3970,761540,637,28810,345,790350,982,normal,-
3308060025184681570,10.0.2.27,152.195.39.165,443,tcp,tls,275420,11958,42,3970,38,15928,80,normal,-
-5679065074748147769,10.0.2.27,184.28.235.226,443,tcp,tls,40890,10376,32,3382,30,13758,62,normal,-
-1468750392492498128,10.0.2.27,104.17.49.95,443,udp,-,203065,1124550,1545,1330926,1535,2455476,3080,normal,-
3236865071385223,10.0.2.27,104.18.22.41,443,udp,-,75114,232623,328,80586,263,313209,591,normal,-
-4408042814664533732,10.0.2.27,195.12.177.81,443,udp,-,1542,13274,20,5172,18,18446,38,normal,-
-1172853118608515609,10.0.2.27,104.17.50.95,443,udp,-,44166,127240,198,60185,198,187425,396,normal,-
2516640758105034276,10.0.2.27,104.18.24.185,443,udp,-,340,13060,20,4046,14,17106,34,normal,-
-6216852942526132626,10.0.2.27,216.239.34.36,443,udp,-,256174,218992,600,135261,514,354253,1114,normal,-
6033083992701461172,10.0.2.27,95.100.146.72,80,tcp,http,652648,27093,128,16884,137,43977,265,normal,-
1876517325869122987,10.0.2.27,104.16.124.96,443,udp,-,4877,2098660,1950,152032,713,2250692,2663,normal,-
4061946954487547670,10.0.2.27,199.232.196.124,443,udp,-,21005,127915,112,16356,63,144271,175,normal,-
2455132228419418938,10.0.2.27,142.251.37.102,443,udp,-,1261,40967,50,13895,47,54862,97,normal,-
-9136687377135213991,10.0.2.27,142.251.36.131,443,udp,-,46651,1539458,1168,65955,520,1605413,1688,normal,-
-7029473931116544964,10.0.2.27,142.251.36.141,443,udp,-,660,21688,28,5304,20,26992,48,normal,-
-9205301059991866527,10.0.2.27,34.107.254.252,443,udp,-,5955,21273,64,30946,73,52219,137,normal,-
-1644285739443119916,10.0.2.27,91.151.132.18,443,udp,-,800,19006,32,4752,20,23758,52,normal,-
-3661565518349875815,10.0.2.27,104.18.167.224,443,udp,-,809,21656,37,8029,20,29685,57,normal,-
6709512234433855152,10.0.2.27,54.173.15.238,443,tcp,tls,42514,19952,54,7576,56,27528,110,normal,-
-2989757252180023319,10.0.2.27,31.13.72.12,443,udp,-,876,16748,26,4068,14,20816,40,normal,-
486553327796105697,10.0.2.27,157.240.30.35,443,udp,-,305694,711065,1093,443888,788,1154953,1881,normal,-
8083450698300424018,10.0.2.27,185.125.190.49,80,tcp,http,230,882,10,862,12,1744,22,normal,-
-5543852838165083224,10.0.2.27,18.66.8.8,443,udp,-,15073,37287,56,15203,49,52490,105,normal,-
7192980974529293718,10.0.2.27,104.19.154.83,443,udp,-,186514,67396,136,29872,101,97268,237,normal,-
-8516041933081064674,10.0.2.27,34.111.9.237,443,udp,-,18222,92042,104,15894,74,107936,178,normal,-
-6364316116751310301,10.0.2.27,142.251.36.106,443,udp,-,7733,867343,668,39088,289,906431,957,normal,-
-8371699327236901248,10.0.2.27,37.157.3.20,443,tcp,tls,240844,14248,44,6638,42,20886,86,normal,-
-2733207360700265538,10.0.2.27,151.101.193.52,443,udp,-,22346,439861,348,28548,175,468409,523,normal,-
-9217456198562958319,10.0.2.27,130.211.23.194,443,udp,-,382,12002,14,3798,12,15800,26,normal,-
9174491055163274263,10.0.2.27,18.66.12.143,80,tcp,-,161767,7992,34,4656,37,12648,71,normal,-
4928931468112056669,10.0.2.27,157.240.221.16,443,udp,-,486,16681,24,5828,19,22509,43,normal,-
7784386670110469747,10.0.2.27,52.97.188.66,443,udp,-,792,26594,22,7178,20,33772,42,normal,-
-7727848972250354351,10.0.2.27,18.66.2.110,443,tcp,tls,118570,45868,58,4932,42,50800,100,normal,-
2756976867677376428,10.0.2.27,142.251.36.99,443,udp,-,125038,1081307,978,104252,488,1185559,1466,normal,-
-3527180266959498163,10.0.2.27,142.251.36.86,443,udp,-,32448,522216,420,28399,151,550615,571,normal,-
3097072303340793521,10.0.2.27,142.251.36.72,443,udp,-,48077,1213083,937,46616,361,1259699,1298,normal,-
6679677968365891126,10.0.2.27,18.66.2.4,443,udp,-,356,12952,18,4380,18,17332,36,normal,-
6270430381355576967,10.0.2.27,34.107.204.85,443,udp,-,303824,82452,263,72216,279,154668,542,normal,-
-2128767720222776569,10.0.2.27,35.244.193.51,443,udp,-,374,12006,14,3798,12,15804,26,normal,-
6282139457159674229,10.0.2.27,142.251.36.144,443,udp,-,522,13982,16,3972,14,17954,30,normal,-
-8522975592145665399,10.0.2.27,142.251.37.112,443,udp,-,830,14152,18,4472,20,18624,38,normal,-
5077976796819534230,10.0.2.27,142.250.27.156,443,udp,-,2664,20568,54,12502,38,33070,92,normal,-
-8571545881228006653,10.0.2.27,142.251.36.81,443,udp,-,38542,19892,38,11060,36,30952,74,normal,-
-1881212389580313750,10.0.2.27,104.18.25.185,443,udp,-,37934,12194,26,10574,24,22768,50,normal,-
-8853766206709471249,10.0.2.27,142.251.36.70,443,udp,-,750,17252,18,3978,14,21230,32,normal,-
495002771784314973,10.0.2.27,142.251.36.138,443,udp,-,852,14740,16,4138,16,18878,32,normal,-
-4964488576866234630,10.0.2.27,34.117.126.186,443,udp,-,428,11984,14,4134,16,16118,30,normal,-
-4169159996602568205,10.0.2.27,157.240.20.52,443,udp,-,658,17440,28,5496,28,22936,56,normal,-
-236501786323423467,10.0.2.27,142.250.27.157,443,udp,-,384,15800,14,4134,16,19934,30,normal,-
-6684859183245804204,10.0.2.27,142.251.36.66,443,udp,-,172598,299790,403,61286,240,361076,643,normal,-
1662152568912479161,10.0.2.27,34.107.222.173,443,udp,-,2214,12286,20,5984,18,18270,38,normal,-
-6863419292468599894,10.0.2.27,104.16.133.229,443,udp,-,603,19965,33,5875,19,25840,52,normal,-
-9007890713240433252,10.0.2.27,35.241.9.51,443,udp,-,400,10828,14,3810,12,14638,26,normal,-
-9115160020629521267,10.0.2.27,192.124.249.23,80,tcp,http,130154,6126,24,2178,24,8304,48,normal,-
-7203762312498104864,10.0.2.27,142.251.37.97,443,udp,-,1479,31952,44,11705,48,43657,92,normal,-
6512555575551643605,10.0.2.27,142.250.102.155,443,udp,-,16220,5650,16,4568,14,10218,30,normal,-
-7808216618470867750,10.0.2.27,23.195.248.244,443,tcp,tls,268943,408752,354,23399,322,432151,676,normal,-
6680557938275413387,10.0.2.27,31.30.189.145,443,udp,-,140347,2490526,2171,132952,810,2623478,2981,normal,-
-6888875619737107600,10.0.2.27,142.250.191.35,443,udp,-,80226,16960,48,7596,32,24556,80,normal,-
7990229417960787645,10.0.2.27,142.251.36.129,443,udp,-,919,28067,34,6918,27,34985,61,normal,-
-3033014531343942339,10.0.2.27,104.18.31.78,443,udp,-,1371,18390,29,5912,20,24302,49,normal,-
-276051275628693693,10.0.2.27,104.18.23.41,443,udp,-,302,10562,18,4044,12,14606,30,normal,-
2362848168345618782,10.0.2.27,34.120.133.55,443,udp,-,15582,15870,22,4876,20,20746,42,normal,-
-7541644672308578235,10.0.2.27,157.240.247.8,443,udp,-,336,11114,16,4172,16,15286,32,normal,-
9136860664394759565,10.0.2.27,142.251.36.150,443,udp,-,18268,101427,113,14993,92,116420,205,normal,-
-8512522249930930454,10.0.2.27,188.185.35.172,80,tcp,http,12316,1002,10,580,10,1582,20,normal,-
309807249557978403,10.0.2.27,35.241.9.150,443,tcp,-,224246,1092,16,1146,16,2238,32,normal,-
2538331365580974310,10.0.2.27,34.223.124.45,80,tcp,http,18030,6288,23,3580,22,9868,45,normal,-
-1315819750748721357,10.0.2.27,188.185.88.30,80,tcp,http,17376,1503,15,870,15,2373,30,normal,-
3167722593576048510,10.0.2.27,185.199.111.133,443,tcp,tls,218455,103069,164,15572,137,118641,301,normal,-
-2080721336353080495,10.0.2.27,188.184.21.108,80,tcp,-,12232,360,6,472,8,832,14,normal,-
8301032815903218789,10.0.2.27,185.199.111.154,443,tcp,tls,397850,107006,165,16195,142,123201,307,normal,-
1351302095206228288,10.0.2.27,140.82.113.26,443,tcp,tls,111494,12892,72,13340,72,26232,144,normal,-
6719459105602216061,10.0.2.27,17.253.73.201,80,tcp,http,196090,5950,30,2542,30,8492,60,normal,-
8009724730561040721,10.0.2.27,77.75.79.115,443,tcp,tls,3000,11174,20,2046,18,13220,38,normal,-
-599476446015954574,10.0.2.27,65.9.95.103,443,tcp,-,224268,1120,16,1202,16,2322,32,normal,-
5441432874706096398,10.0.2.27,142.251.36.68,443,tcp,tls,40595,20281,53,7520,49,27801,102,normal,-
-2392408156561751506,44.235.159.98,10.0.2.27,60472,tcp,-,32031,657,9,700,10,1357,19,normal,-
3990782710670272352,10.0.2.27,77.75.79.69,443,tcp,tls,430500,43859,82,9160,71,53019,153,normal,-
-2882124999842349006,10.0.2.27,90.182.114.17,443,tcp,tls,876,12316,36,4582,36,16898,72,normal,-
956315961247273333,10.0.2.27,185.199.108.133,443,tcp,tls,356,9736,20,2812,22,12548,42,normal,-
2421261367541385558,10.0.2.27,141.95.47.55,443,tcp,tls,1396,8764,24,3180,26,11944,50,normal,-
-283127334794757464,10.0.2.27,77.75.76.101,443,tcp,tls,341956,84658,100,6332,72,90990,172,normal,-
7253342250095883353,10.0.2.27,192.0.73.2,443,tcp,tls,60962,174022,201,14708,121,188730,322,normal,-
-2872038173291419796,10.0.2.27,146.75.120.193,443,tcp,tls,174775,336400,326,22474,272,358874,598,normal,-
-5109983215826520790,10.0.2.27,81.3.201.145,443,tcp,tls,1588,12112,36,4474,34,16586,70,normal,-
-631479754418182521,10.0.2.27,172.64.155.188,80,tcp,http,604277,10230,84,7450,89,17680,173,normal,-
-8990576956711477217,10.0.2.27,185.125.190.48,80,tcp,http,238,882,10,754,10,1636,20,normal,-
8945854410748223438,10.0.2.27,77.75.78.30,443,tcp,tls,430440,217931,248,21934,154,239865,402,normal,-
-785526456944210672,10.0.2.27,142.250.102.154,443,tcp,tls,2019,19219,50,6359,51,25578,101,normal,-
-1822438195352305385,10.0.2.27,37.152.97.20,443,tcp,tls,794,11662,30,4402,32,16064,62,normal,-
-1504890582412882293,10.0.2.27,140.82.121.6,443,tcp,tls,331750,89470,436,308402,430,397872,866,normal,-
5762189338414076004,10.0.2.27,195.122.31.145,443,tcp,tls,1060,12414,36,4478,34,16892,70,normal,-
7452024723960572074,10.0.2.27,65.9.94.165,443,tcp,tls,48914,49362,100,11557,109,60919,209,normal,-
-3761234062177346662,10.0.2.27,54.243.184.121,443,tcp,tls,251550,44404,107,11825,105,56229,212,normal,-
1432421594883630432,10.0.2.27,2.16.2.211,443,tcp,tls,11240,9192,24,2684,24,11876,48,normal,-
-1000904991459935854,10.0.2.27,34.249.230.115,443,tcp,tls,138891,32979,78,10227,72,43206,150,normal,-
-8523755708479085534,10.0.2.27,104.16.133.229,443,tcp,tls,1348,10112,28,3770,28,13882,56,normal,-
-6637486958658029940,10.0.2.27,91.81.129.81,443,tcp,tls,904,11976,34,4474,34,16450,68,normal,-
-5916264762826628893,10.0.2.27,142.251.36.110,443,tcp,tls,76199,208206,187,15774,168,223980,355,normal,-
-8802994265417920044,10.0.2.27,104.19.155.83,443,tcp,tls,952,9912,30,4554,32,14466,62,normal,-
3213624434028459692,10.0.2.27,44.236.72.93,443,tcp,tls,121038,12108,40,4000,40,16108,80,normal,-
-8399973671654786126,10.0.2.27,157.240.201.15,443,tcp,tls,756,16526,42,4610,36,21136,78,normal,-
-5565338154840782347,10.0.2.27,94.153.206.83,443,tcp,tls,1066,12460,42,4692,38,17152,80,normal,-
-1267406944569939922,10.0.2.27,142.251.36.73,443,tcp,tls,2254,12744,40,4656,42,17400,82,normal,-
-4255928346816143253,10.0.2.27,142.251.36.110,443,udp,-,36995,344907,437,198453,317,543360,754,normal,-
1389316777504605523,10.0.2.27,63.35.87.194,443,tcp,tls,168112,22416,59,7880,60,30296,119,normal,-
-3185102594510838431,10.0.2.27,89.151.5.209,443,tcp,tls,996,11724,30,4368,32,16092,62,normal,-
5962513395925171949,10.0.2.27,140.82.121.3,443,tcp,tls,333890,1872628,1556,120090,1262,1992718,2818,normal,-
-3734558049361880016,10.0.2.27,144.2.9.1,443,tcp,tls,86218,9940,34,5596,28,15536,62,normal,-
-3573233671379901740,10.0.2.27,192.124.249.24,80,tcp,http,359739,25097,77,7961,76,33058,153,normal,-
8068047046397941759,10.0.2.27,147.67.210.45,443,tcp,tls,11774,7800,18,2330,20,10130,38,normal,-
-8118599653407271393,10.0.2.27,15.236.125.10,443,tcp,tls,62020,22274,75,20751,73,43025,148,normal,-
8663930453782606110,10.0.2.27,35.186.249.72,443,tcp,tls,844,16186,38,4636,40,20822,78,normal,-
-6090905560373637818,10.0.2.27,78.11.56.212,443,tcp,tls,1484,11982,42,4692,38,16674,80,normal,-
3006639689246396568,10.0.2.27,54.229.62.148,443,tcp,tls,121252,14588,38,4570,42,19158,80,normal,-
-2067008265219790629,10.0.2.27,142.251.37.109,443,tcp,tls,1668,39901,101,15339,100,55240,201,normal,-
1757434537680322656,10.0.2.27,140.82.114.22,443,tcp,tls,330872,26230,122,32178,102,58408,224,normal,-
6280835331045370544,10.0.2.27,162.159.138.232,443,tcp,tls,674,34854,48,4872,36,39726,84,normal,-
1044688080228663957,10.0.2.27,87.240.132.78,443,tcp,-,144,120,2,256,4,376,6,normal,-
-8292876908502497940,10.0.2.27,192.0.77.2,443,tcp,tls,76211,288938,233,10463,126,299401,359,normal,-
8842824572094050046,10.0.2.27,157.240.30.54,443,tcp,tls,128625,100343,137,12210,118,112553,255,normal,-
5527453782552595781,10.0.2.27,34.240.169.134,443,tcp,tls,121882,13664,38,4820,38,18484,76,normal,-
8572457070679739823,10.0.2.27,77.75.77.16,443,tcp,tls,106780,99070,182,18828,163,117898,345,normal,-
-7385234590032347028,10.0.2.27,52.51.183.68,443,tcp,tls,122136,18522,42,4578,40,23100,82,normal,-
-6589562081709794177,10.0.2.27,157.240.253.35,443,tcp,tls,341688,9934,40,4046,40,13980,80,normal,-
-2558349853758273429,10.0.2.27,31.13.84.4,443,tcp,tls,964,12768,34,4472,34,17240,68,normal,-
-5350512189761722482,10.0.2.27,192.0.76.3,443,tcp,tls,66831,19522,48,5705,47,25227,95,normal,-
6334898424475994774,10.0.2.27,77.75.76.182,443,tcp,-,175926,21972,68,7593,69,29565,137,normal,-
4615034079291053016,10.0.2.27,2.16.2.10,443,tcp,tls,40462,12380,36,7138,30,19518,66,normal,-
-162101779341819745,10.0.2.27,37.152.97.20,443,udp,-,298,10478,16,4172,16,14650,32,normal,-
-7590782111157849443,10.0.2.27,52.98.228.50,443,tcp,tls,862,35304,48,4584,40,39888,88,normal,-
-3986997486534726692,10.0.2.27,151.101.193.69,443,tcp,tls,564,13100,26,3006,24,16106,50,normal,-
-902927494005495588,10.0.2.27,104.17.211.204,443,tcp,tls,342678,11036,38,4382,36,15418,74,normal,-
9181770642255098402,10.0.2.27,104.17.68.176,443,tcp,tls,350024,53982,72,6590,72,60572,144,normal,-
947924890725562752,10.0.2.27,104.244.42.67,443,tcp,tls,430112,15566,68,11880,68,27446,136,normal,-
7919583625112698718,10.0.2.27,95.100.146.40,443,tcp,tls,286894,26144,98,9092,96,35236,194,normal,-
6182235047787675768,10.0.2.27,77.75.78.124,443,tcp,tls,175243,2570000,1974,81382,1277,2651382,3251,normal,-
5046604806055459604,10.0.2.27,151.101.193.111,443,tcp,tls,342078,14206,42,4046,40,18252,82,normal,-
-7008938485618604649,10.0.2.27,23.22.33.246,443,tcp,tls,496611,25545,117,81425,115,106970,232,normal,-
-2305564931842721497,10.0.2.27,13.107.226.44,443,tcp,tls,502707,29968,75,8461,73,38429,148,normal,-
-1512803151516040501,10.0.2.27,95.100.146.24,443,tcp,tls,247312,673173,573,39560,506,712733,1079,normal,-
-3174485002329652303,10.0.2.27,77.75.79.232,443,tcp,tls,171886,14334,44,5652,44,19986,88,normal,-
1040847348852448885,10.0.2.27,95.100.146.19,443,tcp,tls,247326,547610,472,26282,286,573892,758,normal,-
-7745603492544451181,10.0.2.27,20.44.10.123,443,tcp,tls,372454,28205,101,48901,94,77106,195,normal,-
-5188475685019524289,10.0.2.27,65.9.95.79,443,tcp,tls,337066,58432,82,7956,80,66388,162,normal,-
8618005934332207109,10.0.2.27,104.18.43.158,443,tcp,tls,340796,9842,36,4428,36,14270,72,normal,-
3785114591255789611,10.0.2.27,35.169.28.197,443,tcp,tls,335596,15146,50,5668,48,20814,98,normal,-
5813968839017962702,10.0.2.27,23.195.249.197,443,tcp,tls,40228,14258,36,3458,32,17716,68,normal,-
-1561201799299117027,10.0.2.27,65.9.95.66,443,tcp,tls,514116,23886,71,7984,72,31870,143,normal,-
-684355745907591462,10.0.2.27,65.9.95.55,443,tcp,tls,29858,21280,43,4811,43,26091,86,normal,-
-5740442723035448,10.0.2.27,104.17.230.204,443,tcp,tls,386876,14358,70,7526,70,21884,140,normal,-
995268718866096850,10.0.2.27,104.16.123.96,443,tcp,tls,342712,8970,34,3870,36,12840,70,normal,-
3662499323566603715,10.0.2.27,157.240.20.35,443,tcp,tls,764,16484,42,4092,34,20576,76,normal,-
6664582611695499391,10.0.2.27,34.251.47.116,443,tcp,tls,342,6328,12,1722,12,8050,24,normal,-
-4785764877684447683,10.0.2.27,151.101.65.69,443,tcp,tls,374874,499152,476,105194,378,604346,854,normal,-
-5337358828594992849,10.0.2.27,200.147.35.149,443,tcp,tls,129990,13572,43,5647,45,19219,88,normal,-
6411383973435631631,10.0.2.27,68.219.88.97,443,tcp,tls,254818,16766,42,8438,40,25204,82,normal,-
-3434610773996906481,10.0.2.27,34.199.87.156,443,tcp,tls,337516,14206,44,4896,38,19102,82,normal,-
6871233828124763732,10.0.2.27,142.250.102.157,443,tcp,tls,624,13570,40,4542,34,18112,74,normal,-
-3598042126078861761,10.0.2.27,95.100.146.67,443,tcp,tls,41054,10266,30,3058,24,13324,54,normal,-
-7361368718983896470,10.0.2.27,64.4.250.36,443,tcp,tls,60720,10548,32,4066,26,14614,58,normal,-
-8297058327088929191,10.0.2.27,40.126.31.71,443,tcp,tls,231250,24698,54,5276,48,29974,102,normal,-
1164420329491680290,10.0.2.27,104.22.7.216,443,tcp,tls,341574,9146,36,3722,34,12868,70,normal,-
679006360885805973,10.0.2.27,52.22.41.97,443,tcp,tls,198340,23470,70,8934,73,32404,143,normal,-
-3095343659564160689,10.0.2.27,185.66.189.42,443,tcp,tls,53407,22707,59,7210,57,29917,116,normal,-
8445371261745918152,10.0.2.27,2.16.2.203,443,tcp,tls,346,11392,24,2952,24,14344,48,normal,-
-5611050990452175722,10.0.2.27,44.227.222.81,443,tcp,tls,269510,16872,52,5572,50,22444,102,normal,-
-830187104607593983,10.0.2.27,142.250.27.155,443,tcp,tls,1006,13454,38,4636,36,18090,74,normal,-
5955571785693446483,10.0.2.27,13.107.43.14,443,tcp,tls,246396,13026,36,5146,34,18172,70,normal,-
-4033564754153026279,10.0.2.27,198.143.164.252,443,tcp,tls,255660,1288570,1046,63354,828,1351924,1874,normal,-
-2584252707847750740,10.0.2.27,192.0.77.48,443,tcp,tls,61561,15672,42,4904,44,20576,86,normal,-
601455987084103761,10.0.2.27,104.22.6.216,443,tcp,tls,341538,8890,32,3614,32,12504,64,normal,-
-3132509300549259313,10.0.2.27,65.9.9.67,443,tcp,tls,343294,14956,40,4194,42,19150,82,normal,-
4712879795688532666,10.0.2.27,65.9.95.23,443,tcp,tls,341986,16406,44,4816,42,21222,86,normal,-
7675715081578779056,10.0.2.27,52.167.30.171,443,tcp,tls,247272,36128,54,6946,42,43074,96,normal,-
8393139957074062311,10.0.2.27,104.244.42.69,443,tcp,tls,430800,13308,68,11938,68,25246,136,normal,-
2440493582782956213,10.0.2.27,65.9.95.61,443,tcp,tls,372512,20512,54,5948,52,26460,106,normal,-
6175463565678477624,10.0.2.27,77.75.77.234,443,tcp,tls,175666,14412,40,4694,40,19106,80,normal,-
-8198092258251877218,10.0.2.27,20.119.174.243,443,tcp,tls,26724,16284,42,14396,44,30680,86,normal,-
-8214844873374459556,10.0.2.27,34.239.220.159,443,tcp,tls,340828,14004,42,4362,42,18366,84,normal,-
3663637284128678035,10.0.2.27,54.186.100.168,443,tcp,tls,163098,44392,221,84788,216,129180,437,normal,-
-1588563426661540187,10.0.2.27,20.112.52.29,443,tcp,tls,343788,18860,46,4370,46,23230,92,normal,-
-4977150542647544300,10.0.2.27,91.81.129.81,443,udp,-,356,10492,16,3660,10,14152,26,normal,-
-7142657849407434404,10.0.2.27,104.19.155.83,443,udp,-,45278,25666,54,16220,48,41886,102,normal,-
-3905001738830296707,10.0.2.27,94.153.206.83,443,udp,-,464,10496,16,3820,12,14316,28,normal,-
-6022870484707785675,10.0.2.27,142.251.37.118,443,udp,-,2292,163590,145,11883,60,175473,205,normal,-
7941171747055856184,10.0.2.27,162.159.138.232,443,udp,-,2178,85884,146,83254,146,169138,292,normal,-
-4430569144363152178,10.0.2.27,78.11.56.212,443,udp,-,302,10490,16,3648,10,14138,26,normal,-
-406671849209304989,10.0.2.27,142.251.37.109,443,udp,-,9675,288842,259,26279,119,315121,378,normal,-
7101769290716582038,10.0.2.27,142.251.36.68,443,udp,-,94702,676708,880,152925,474,829633,1354,normal,-
5673293423196713424,10.0.2.27,157.240.253.60,443,udp,-,418,10604,16,3646,10,14250,26,normal,-
-8186281446987647483,10.0.2.27,185.125.190.18,80,tcp,http,236,882,10,754,10,1636,20,normal,-
8298132371094826213,10.0.2.27,65.9.9.138,80,tcp,http,545785,13753,80,8513,84,22266,164,normal,-
-1524766178500352791,10.0.2.27,89.151.5.209,443,udp,-,368,10502,16,3832,12,14334,28,normal,-
5649884848997945349,10.0.2.27,204.79.197.203,80,tcp,http,230274,11196,36,3724,36,14920,72,normal,-
-6739637255644300486,10.0.2.27,157.240.201.15,443,udp,-,300,11132,16,3652,10,14784,26,normal,-
-8122477203916459866,10.0.2.27,35.186.249.72,443,udp,-,372,15142,16,3810,12,18952,28,normal,-
830149311402891657,10.0.2.27,142.250.27.155,443,udp,-,494,14440,16,3974,14,18414,30,normal,-
-7943583085605015930,10.0.2.27,157.240.30.54,443,udp,-,9909,3981059,3186,91022,763,4072081,3949,normal,-
874809959066274968,10.0.2.27,142.250.102.154,443,udp,-,512,14440,16,3798,12,18238,28,normal,-
-3449646799816035150,10.0.2.27,81.3.201.145,443,udp,-,316,10496,16,3650,10,14146,26,normal,-
392929471440545718,10.0.2.27,142.251.36.73,443,udp,-,388,14026,16,4138,16,18164,32,normal,-
8531570244135249372,10.0.2.27,142.250.102.157,443,udp,-,346,4524,8,3258,6,7782,14,normal,-
2580779815344997808,10.0.2.27,2.16.2.187,443,tcp,tls,242658,15596,48,5332,48,20928,96,normal,-
6144125281574636143,10.0.2.27,108.177.119.127,19302,udp,-,114,148,2,124,2,272,4,normal,-
7422525754424561644,10.0.2.27,195.122.31.145,443,udp,-,440,10506,16,3828,12,14334,28,normal,-
8884402252141191052,10.0.2.27,104.64.163.250,443,tcp,tls,240822,13380,44,4834,44,18214,88,normal,-
4012957007186227784,10.0.2.27,157.240.253.60,443,tcp,tls,1018,15284,40,4308,38,19592,78,normal,-
5322835739577089355,10.0.2.27,157.240.20.35,443,udp,-,248,11136,16,3650,10,14786,26,normal,-
-1221788583831863366,10.0.2.27,90.182.114.17,443,udp,-,334,10476,16,3656,10,14132,26,normal,-
-5930445695147363803,10.0.2.27,52.98.228.50,443,udp,-,734,26738,24,7004,18,33742,42,normal,-
-898013437747787789,10.0.2.27,31.13.84.4,443,udp,-,1076,11198,16,4144,16,15342,32,normal,-
-6464988903717649381,10.0.2.40,224.0.0.251,5353,udp,-,0,0,0,915,5,915,5,normal,-
7204320172535837837,10.0.2.40,65.9.95.103,443,tcp,tls,171061,21067,46,5125,44,26192,90,normal,-
-8300882757762501776,10.0.2.40,151.101.129.69,443,tcp,tls,176571,250300,269,19786,199,270086,468,normal,-
-2858531100322804808,10.0.2.40,142.251.36.129,443,tcp,tls,2937,64123,129,14770,123,78893,252,normal,-
-6937078191452859220,10.0.2.40,142.251.36.138,443,tcp,tls,82806,57588,197,28674,191,86262,388,normal,-
-5963464933022885320,10.0.2.40,192.0.73.2,443,tcp,tls,33862,48336,121,15540,113,63876,234,normal,-
-6469685663857721703,10.0.2.40,18.156.0.31,443,tcp,tls,1492,3044,8,1614,10,4658,18,normal,-
6183852199707606436,10.0.2.40,77.75.79.234,443,tcp,tls,506,12782,28,3028,26,15810,54,normal,-
-2279042720040681949,10.0.2.40,142.251.36.130,443,tcp,tls,389485,84988,210,27318,200,112306,410,normal,-
-8470423178625295724,10.0.2.40,64.158.223.137,443,tcp,tls,866,3284,8,1614,10,4898,18,normal,-
-6601857275728521565,10.0.2.40,151.101.65.69,443,tcp,tls,588,13340,30,3114,26,16454,56,normal,-
6074217392350809731,10.0.2.40,77.75.76.209,443,tcp,tls,1987,42417,91,10220,84,52637,175,normal,-
8225374427414458484,10.0.2.40,77.75.78.196,443,tcp,tls,598428,175332,303,50351,262,225683,565,normal,-
-3623585562648205381,10.0.2.40,77.75.77.195,443,tcp,tls,439724,402299,500,39520,408,441819,908,normal,-
1373962483538830655,10.0.2.40,52.208.110.188,443,tcp,tls,940,694,8,1614,10,2308,18,normal,-
8445216103531183679,10.0.2.40,77.75.78.30,443,tcp,tls,879791,624316,745,117222,546,741538,1291,normal,-
-4915774367215549884,10.0.2.40,185.199.111.154,443,tcp,-,346499,40516,100,11772,101,52288,201,normal,-
455677654030233574,10.0.2.40,185.199.108.133,443,tcp,tls,348,9806,20,2812,22,12618,42,normal,-
2333772397311023780,10.0.2.40,77.75.79.195,443,tcp,tls,1223223,2448022,2066,85670,1231,2533692,3297,normal,-
2911651026560204598,10.0.2.40,95.100.146.65,443,tcp,tls,42102,62984,76,5740,54,68724,130,normal,-
-7183723190417307501,10.0.2.40,95.100.146.72,80,tcp,-,809476,47562,175,27808,183,75370,358,normal,-
636223782786945861,10.0.2.40,52.20.134.127,443,tcp,tls,1260,5728,10,1722,12,7450,22,normal,-
8661602855883751611,10.0.2.40,98.98.134.242,443,tcp,tls,1126,8942,18,2282,18,11224,36,normal,-
-5269511026979565682,10.0.2.40,34.91.62.186,443,tcp,tls,1164,9438,16,2362,18,11800,34,normal,-
6559254286747274302,10.0.2.40,142.251.36.70,443,tcp,tls,922,18979,44,5447,42,24426,86,normal,-
5796044731056225812,10.0.2.40,77.75.78.126,443,tcp,tls,342695,89071,118,8797,91,97868,209,normal,-
-9143565583589358577,10.0.2.40,145.239.237.56,443,tcp,-,100883,5036,21,2377,24,7413,45,normal,-
-520726547658686183,10.0.2.40,185.89.210.46,443,tcp,tls,31134,14604,42,7423,37,22027,79,normal,-
5245862881264342696,10.0.2.40,77.75.77.234,443,tcp,tls,175612,95873,125,10596,108,106469,233,normal,-
-6882262725377225237,10.0.2.40,34.120.208.123,443,tcp,tls,458088,52610,295,85661,250,138271,545,normal,-
-5776233064668544783,10.0.2.40,157.240.30.27,443,tcp,tls,171293,113209,124,7651,77,120860,201,normal,-
5789629382881434271,10.0.2.40,77.75.76.101,443,tcp,-,599586,143273,366,71273,332,214546,698,normal,-
-8685553368245155483,10.0.2.40,37.157.2.249,443,tcp,tls,67030,738992,558,27378,418,766370,976,normal,-
-687178488487559437,10.0.2.40,77.75.78.104,443,tcp,tls,138708,133632,239,48982,243,182614,482,normal,-
5165726089860179105,10.0.2.40,54.80.38.94,443,tcp,tls,1308,3284,8,1614,10,4898,18,normal,-
7347450135015768184,10.0.2.40,142.251.36.66,443,tcp,tls,373869,240746,304,23835,232,264581,536,normal,-
985102377412752142,10.0.2.40,77.75.78.36,443,tcp,tls,261473,25409,71,12976,70,38385,141,normal,-
-8847378134861233881,10.0.2.40,77.75.78.209,443,tcp,tls,58541,1443911,1155,48905,681,1492816,1836,normal,-
-2745207708461745293,10.0.2.40,85.114.159.118,443,tcp,tls,852,7878,18,2340,20,10218,38,normal,-
5691323621374486791,10.0.2.40,141.95.47.54,443,tcp,tls,370992,138496,247,33167,221,171663,468,normal,-
-9206264762457311371,10.0.2.40,185.199.111.133,443,tcp,tls,175526,37770,105,13041,107,50811,212,normal,-
-5491766062712272337,10.0.2.40,157.240.225.3,443,tcp,tls,922,12950,34,4360,32,17310,66,normal,-
8914530018196174190,10.0.2.40,146.75.120.193,443,tcp,tls,172651,121679,148,11268,109,132947,257,normal,-
9178480907122710277,10.0.2.40,142.251.36.99,80,tcp,http,1052203,37521,196,27138,206,64659,402,normal,-
-5985492938502469893,10.0.2.40,102.132.100.1,443,tcp,tls,2516,12462,34,4646,32,17108,66,normal,-
-4142098523543969322,10.0.2.40,141.95.47.53,443,tcp,tls,1061,8826,25,3308,28,12134,53,normal,-
4597175590591560294,10.0.2.40,91.228.74.159,443,tcp,tls,1496,8348,16,2232,18,10580,34,normal,-
3646834358022607322,10.0.2.40,31.30.189.145,443,tcp,tls,1799,69243,113,11504,96,80747,209,normal,-
4093420600489231282,10.0.2.40,142.251.36.100,443,tcp,tls,1058,24121,54,6900,52,31021,106,normal,-
-1791781110167461773,10.0.2.40,182.161.74.16,443,tcp,tls,12254,8087,23,3181,23,11268,46,normal,-
1234173857993675636,10.0.2.40,185.29.134.248,443,tcp,tls,1618,8432,20,2340,20,10772,40,normal,-
-7367445526589702666,10.0.2.40,52.223.40.198,443,tcp,tls,868,8202,20,2514,22,10716,42,normal,-
1289841660512995081,10.0.2.40,157.240.30.174,443,tcp,tls,1104,56094,70,5584,62,61678,132,normal,-
6369034420459052432,10.0.2.40,77.75.76.104,443,tcp,tls,29920,55339,117,15144,103,70483,220,normal,-
-7088371921465552611,10.0.2.40,34.107.221.82,80,tcp,http,527007,5564,69,5762,72,11326,141,normal,-
4423353163915150982,10.0.2.40,151.101.194.49,443,tcp,tls,1444,9132,12,1830,14,10962,26,normal,-
3073310282923897583,10.0.2.40,37.252.173.215,443,tcp,tls,784,7054,18,2340,20,9394,38,normal,-
8173534647234688879,10.0.2.40,104.18.32.68,80,tcp,http,973574,28742,159,18223,169,46965,328,normal,-
-2373361937853716422,10.0.2.40,142.251.36.67,443,tcp,tls,316250,88054,154,15897,139,103951,293,normal,-
-8807558026129358254,10.0.2.40,157.240.30.18,443,tcp,tls,31287,67452,190,24494,174,91946,364,normal,-
2455170721250986490,10.0.2.40,140.82.112.21,443,tcp,tls,244698,13126,54,9778,50,22904,104,normal,-
6903807025941520951,10.0.2.40,142.251.36.106,443,tcp,tls,560306,53642,210,29861,207,83503,417,normal,-
4523234780541339710,10.0.2.40,67.220.224.150,443,tcp,tls,806,8964,14,1830,14,10794,28,normal,-
-5842325069443143439,10.0.2.40,3.127.117.202,443,tcp,-,2288,180,3,384,6,564,9,normal,-
-3468897719947996845,10.0.2.40,52.49.125.96,443,tcp,tls,1974,12368,24,2622,24,14990,48,normal,-
-7287020145800856578,10.0.2.40,15.236.125.10,443,tcp,tls,91873,18177,52,8092,52,26269,104,normal,-
-8559720907069133910,10.0.2.40,77.75.78.157,443,tcp,tls,431488,36059,95,10604,93,46663,188,normal,-
6902469231642634160,10.0.2.40,77.75.77.69,443,tcp,tls,342254,13574,40,4046,40,17620,80,normal,-
-4547872166571972728,10.0.2.40,77.75.79.232,443,tcp,tls,343053,21937,68,10806,67,32743,135,normal,-
2545397200075795955,10.0.2.40,52.17.66.47,443,tcp,tls,1716,12674,18,2406,20,15080,38,normal,-
-6327332010817395328,10.0.2.40,192.124.249.24,80,tcp,http,237459,21445,54,6503,57,27948,111,normal,-
388022596285006980,10.0.2.40,142.251.37.110,443,tcp,tls,691937,131303,225,22592,204,153895,429,normal,-
-5371701172044796778,10.0.2.40,140.82.113.25,443,tcp,tls,20554,10058,42,7992,42,18050,84,normal,-
5747244660541281608,10.0.2.40,37.157.6.241,443,tcp,tls,241028,18534,50,7154,44,25688,94,normal,-
-3837614232147178464,10.0.2.40,140.82.121.3,443,tcp,tls,248728,880792,704,46478,574,927270,1278,normal,-
-9219617196825860651,10.0.2.40,192.229.221.95,80,tcp,-,998087,39737,192,27814,204,67551,396,normal,-
4021441326059132093,10.0.2.40,37.157.6.236,443,tcp,tls,60202,12538,36,3746,34,16284,70,normal,-
4470910783173176827,10.0.2.40,216.239.32.36,443,tcp,tls,472477,19192,54,5745,54,24937,108,normal,-
-7787440199448055582,10.0.2.40,104.244.42.8,443,tcp,tls,342164,10470,38,4692,40,15162,78,normal,-
-6160062601127280529,10.0.2.40,8.8.8.8,53,udp,dns,4012038,251798,1545,140497,1547,392295,3092,normal,-
1761868073079698729,10.0.2.40,77.75.76.36,443,tcp,tls,343237,22036,62,7332,59,29368,121,normal,-
4019427561619061505,10.0.2.40,147.229.9.226,443,tcp,tls,97730,51383,112,15752,107,67135,219,normal,-
-1213148422200562150,10.0.2.40,213.155.156.184,443,tcp,tls,1616,10062,16,2046,18,12108,34,normal,-
-6926744563921833588,10.0.2.40,104.17.32.82,443,tcp,-,171559,12758,33,3759,36,16517,69,normal,-
5916521988186977829,10.0.2.40,23.195.248.26,443,tcp,tls,485217,1724202,1301,70836,1134,1795038,2435,normal,-
-1111598204561209942,10.0.2.40,140.82.121.5,443,tcp,tls,244754,38148,224,196634,216,234782,440,normal,-
-713025521843230782,10.0.2.40,142.251.36.67,443,udp,-,40496,211231,257,51155,194,262386,451,normal,-
3716778868251616006,10.0.2.40,77.75.78.54,443,tcp,tls,341870,28873,84,11282,82,40155,166,normal,-
2173939354099820558,10.0.2.40,157.240.30.3,443,tcp,tls,16862,26053,245,95991,211,122044,456,normal,-
-3511570103380111899,10.0.2.40,142.251.36.134,443,udp,-,1587,43716,51,12721,49,56437,100,normal,-
-8459242407987014970,10.0.2.40,104.18.7.29,443,tcp,tls,176852,268134,268,18044,187,286178,455,normal,-
-1443048749772553682,10.0.2.40,77.75.79.129,443,tcp,tls,602117,22154,73,7893,71,30047,144,normal,-
-1131005594821913129,10.0.2.40,142.251.37.97,443,udp,-,650,35026,34,5314,24,40340,58,normal,-
4980314745071753960,10.0.2.40,142.251.36.98,443,udp,-,77938,131273,246,50948,181,182221,427,normal,-
-5915742584865864756,10.0.2.40,188.40.16.209,443,tcp,tls,129661,43567,64,5446,57,49013,121,normal,-
3319978329061268320,10.0.2.40,142.251.36.98,443,tcp,tls,598025,40330,109,14664,109,54994,218,normal,-
873945906788331518,10.0.2.40,93.184.220.66,443,tcp,tls,231746,291948,246,10126,128,302074,374,normal,-
819283168079356809,10.0.2.40,34.111.129.221,443,tcp,tls,860,8048,14,1938,16,9986,30,normal,-
-793037717308460752,10.0.2.40,23.195.248.208,443,tcp,tls,228285,127726,150,13007,124,140733,274,normal,-
8251418852559881624,10.0.2.40,37.157.3.30,443,tcp,tls,1628,10514,16,1938,16,12452,32,normal,-
2718464472224033605,10.0.2.40,104.26.4.62,443,tcp,tls,175606,54061,81,7623,64,61684,145,normal,-
6364904535287213742,10.0.2.40,104.18.21.226,80,tcp,http,564519,18414,86,8090,91,26504,177,normal,-
2950178076523480721,10.0.2.40,157.240.30.174,443,udp,-,280,11248,16,3654,10,14902,26,normal,-
4154670656344414925,10.0.2.40,172.64.155.188,80,tcp,http,396350,13829,69,8399,74,22228,143,normal,-
5329352358862930430,10.0.2.40,185.125.190.49,80,tcp,http,246,882,10,754,10,1636,20,normal,-
3406430406317997310,10.0.2.40,13.107.21.200,443,tcp,tls,306133,70309,169,23419,164,93728,333,normal,-
-618706304030196309,10.0.2.40,142.251.36.130,443,udp,-,2710,50825,77,18364,72,69189,149,normal,-
4779847856088591489,10.0.2.40,65.9.9.138,80,tcp,http,621395,17599,100,11114,107,28713,207,normal,-
4741331346887668061,10.0.2.40,142.251.36.72,443,udp,-,13878,91080,103,20603,70,111683,173,normal,-
-186544058070580717,10.0.2.40,34.160.144.191,443,tcp,tls,341094,24702,54,4606,46,29308,100,normal,-
-7336397909627083310,10.0.2.40,95.100.146.42,443,tcp,tls,40544,10848,34,3668,26,14516,60,normal,-
-6032692503179756293,10.0.2.40,2.16.2.99,443,tcp,tls,240800,115326,116,5660,56,120986,172,normal,-
-5904838233977232470,10.0.2.40,40.79.197.34,443,tcp,tls,315104,80704,212,100376,215,181080,427,normal,-
-4020755582145103535,10.0.2.40,157.240.241.1,443,tcp,tls,1594,12996,40,4646,36,17642,76,normal,-
5995537631864959219,10.0.2.40,77.75.76.20,443,tcp,tls,690344,30607,150,107055,149,137662,299,normal,-
-7362122986385334298,10.0.2.40,188.185.22.9,80,tcp,http,10760,762,6,472,8,1234,14,normal,-
-6613628174570395413,10.0.2.40,185.66.189.42,443,tcp,tls,340910,16748,44,4852,42,21600,86,normal,-
8030294058665108652,10.0.2.40,77.75.78.70,443,tcp,tls,343660,61468,80,5344,54,66812,134,normal,-
-6116471534881728415,10.0.2.40,142.250.74.206,443,udp,-,560,19650,24,5514,28,25164,52,normal,-
-4238522894775686660,10.0.2.40,179.60.192.7,443,tcp,tls,798,12206,34,4258,30,16464,64,normal,-
-2253854053890038261,10.0.2.40,17.253.144.10,443,tcp,tls,1264,10262,28,3544,28,13806,56,normal,-
810412076111924750,10.0.2.40,104.87.145.13,443,tcp,tls,140334,21880,49,7757,58,29637,107,normal,-
2048359012295492620,10.0.2.40,142.251.37.110,443,udp,-,94123,835203,1068,283737,781,1118940,1849,normal,-
3604791478764203031,10.0.2.40,104.18.6.29,443,tcp,tls,424,12194,24,2920,24,15114,48,normal,-
4522858671825033040,10.0.2.40,13.107.42.14,443,tcp,tls,273558,59805,140,17042,128,76847,268,normal,-
-8987398812932406445,10.0.2.40,2.16.2.194,443,tcp,tls,40520,9852,32,3422,28,13274,60,normal,-
-8869675271068644003,10.0.2.40,52.19.200.27,443,tcp,tls,122000,18418,42,4578,40,22996,82,normal,-
-1198194684312319168,10.0.2.40,142.251.36.129,443,udp,-,9834,67625,91,18926,88,86551,179,normal,-
-2863438879507007975,10.0.2.40,34.223.124.45,80,tcp,http,18036,6280,23,3564,22,9844,45,normal,-
-1484827764956109228,10.0.2.40,104.17.49.95,443,tcp,tls,133350,25023,72,8891,72,33914,144,normal,-
-3840984740697279135,10.0.2.40,104.17.33.82,443,tcp,tls,1904,64922,96,9662,82,74584,178,normal,-
2207185725403389555,10.0.2.40,146.59.30.100,443,tcp,tls,202902,21038,52,5118,42,26156,94,normal,-
5863907594894713521,10.0.2.40,104.18.43.158,443,tcp,tls,341344,10042,40,4536,38,14578,78,normal,-
-2791342010832398769,10.0.2.40,142.251.37.97,443,tcp,tls,341298,20404,42,4262,44,24666,86,normal,-
-2590727809705575401,10.0.2.40,147.67.34.45,443,tcp,tls,10280,7800,18,2330,20,10130,38,normal,-
-4438908468293544729,10.0.2.40,142.250.186.65,443,udp,-,446,23938,22,4144,16,28082,38,normal,-
-2595322227602647126,10.0.2.40,77.75.78.101,443,tcp,tls,519778,24428,90,18268,88,42696,178,normal,-
2681766663162537665,10.0.2.40,77.75.79.115,443,tcp,tls,512866,106449,129,8660,93,115109,222,normal,-
-3900440195353012471,10.0.2.40,142.251.36.132,443,tcp,tls,637288,19758,64,6816,67,26574,131,normal,-
-2886190315758360926,10.0.2.40,95.100.146.24,443,tcp,tls,192502,666934,548,25120,297,692054,845,normal,-
4331923452842995154,10.0.2.40,31.13.84.4,443,udp,-,502,13416,23,5328,14,18744,37,normal,-
1622732799414714691,10.0.2.40,142.251.36.97,443,tcp,tls,175133,94518,143,14665,131,109183,274,normal,-
-6620166684624115958,10.0.2.40,31.30.189.77,443,tcp,-,116184,10685,35,3685,38,14370,73,normal,-
5066301673739860764,10.0.2.40,93.185.98.103,443,tcp,tls,154961,1733623,1380,82595,1118,1816218,2498,normal,-
312982307967587581,10.0.2.40,131.253.33.203,80,tcp,http,196028,8751,33,3147,33,11898,66,normal,-
6175014044439403993,10.0.2.40,13.107.238.44,443,tcp,tls,381379,44280,69,7232,66,51512,135,normal,-
-4900567431201818588,10.0.2.40,142.251.36.86,443,udp,-,6887,959050,753,29246,236,988296,989,normal,-
-2764448439053062839,10.0.2.40,37.157.5.141,443,tcp,-,160689,61494,186,55608,227,117102,413,normal,-
-5764782459158196599,10.0.2.40,65.9.94.165,443,tcp,tls,49517,49362,100,11557,109,60919,209,normal,-
-7600114215226412925,10.0.2.40,34.117.237.239,443,tcp,tls,499327,20895,71,7608,73,28503,144,normal,-
724357245577793392,10.0.2.40,185.86.138.16,443,tcp,-,146473,91194,237,61832,275,153026,512,normal,-
-6471022366029443849,10.0.2.40,65.9.95.48,443,tcp,tls,680,14674,26,3028,26,17702,52,normal,-
-2571754646403430036,10.0.2.40,213.19.162.21,443,tcp,tls,42949,37807,105,21130,115,58937,220,normal,-
7618107053532986220,10.0.2.40,142.251.36.110,443,tcp,-,918,41793,46,3258,33,45051,79,normal,-
997417442700730475,10.0.2.40,44.236.72.93,443,tcp,tls,120886,12248,42,4108,42,16356,84,normal,-
-2275768115986786428,10.0.2.40,185.64.189.112,443,tcp,tls,62148,15878,39,6756,41,22634,80,normal,-
-3946320445844342661,10.0.2.40,18.185.190.27,443,tcp,tls,75585,24506,64,14174,71,38680,135,normal,-
6003437784581117346,10.0.2.40,54.186.32.120,443,tcp,tls,102142,27806,146,59556,138,87362,284,normal,-
-2184871358818031260,10.0.2.40,34.98.64.218,443,tcp,tls,2684,12720,32,6220,32,18940,64,normal,-
7162433003567393662,10.0.2.40,198.47.127.21,443,tcp,tls,138047,52256,142,38117,179,90373,321,normal,-
-4442134799455861112,10.0.2.40,172.64.154.85,443,tcp,tls,259360,11474,36,4434,36,15908,72,normal,-
-8791920108481117739,10.0.2.40,185.184.8.90,443,tcp,tls,130208,15696,50,5666,50,21362,100,normal,-
-256320907212819267,10.0.2.40,52.211.112.159,443,tcp,tls,127886,19372,50,8382,48,27754,98,normal,-
4251900021835435476,10.0.2.40,52.48.67.205,443,tcp,tls,2428,13454,26,3180,26,16634,52,normal,-
-9198585106164591045,10.0.2.40,188.185.87.101,80,tcp,http,16529,1503,15,870,15,2373,30,normal,-
-3573057374827137101,10.0.2.40,104.19.155.83,443,tcp,tls,386770,12382,47,5367,47,17749,94,normal,-
8687725603957880355,10.0.2.40,188.65.124.92,443,tcp,tls,147340,162744,204,53232,169,215976,373,normal,-
-6657083257449983766,10.0.2.40,142.251.37.106,443,tcp,tls,171148,63197,85,8352,82,71549,167,normal,-
-2762635154202792164,10.0.2.40,91.198.174.208,443,tcp,tls,208985,206815,256,22558,191,229373,447,normal,-
4781550187422199673,10.0.2.40,185.181.177.73,443,tcp,tls,111802,11086,32,4768,26,15854,58,normal,-
2645684182743032203,10.0.2.40,192.0.77.48,443,tcp,tls,35931,15504,40,5006,41,20510,81,normal,-
-5814400930891960812,10.0.2.40,186.192.90.12,443,tcp,tls,162038,19225,46,5782,48,25007,94,normal,-
7478375735083606360,10.0.2.40,178.79.227.76,443,tcp,tls,5078,60282,112,12618,111,72900,223,normal,-
-394295639700084807,10.0.2.40,20.119.174.243,443,tcp,tls,40130,28548,65,16410,66,44958,131,normal,-
2731168747825089004,10.0.2.40,65.9.95.67,443,tcp,tls,262308,16282,42,4924,44,21206,86,normal,-
-6032853489812667878,10.0.2.40,34.107.204.85,443,tcp,tls,261480,18696,48,5452,51,24148,99,normal,-
6925507060388711861,10.0.2.40,142.251.36.142,443,tcp,tls,740577,141403,180,17619,174,159022,354,normal,-
6341051513794479706,10.0.2.40,13.107.226.44,443,tcp,tls,402191,28119,65,7360,62,35479,127,normal,-
5409331867678578023,10.0.2.40,151.101.193.16,443,tcp,tls,136473,912197,955,82758,675,994955,1630,normal,-
-79210832680404743,10.0.2.40,172.67.4.41,443,tcp,tls,173284,8614,28,3320,28,11934,56,normal,-
-4376125624480284942,10.0.2.40,188.65.124.58,443,tcp,tls,47612,15828,54,40444,56,56272,110,normal,-
-6501741155612882999,10.0.2.40,157.240.30.35,443,tcp,tls,397530,14903,60,7123,57,22026,117,normal,-
1370990979136003754,10.0.2.40,142.251.37.99,443,tcp,tls,235480,75598,129,12820,109,88418,238,normal,-
-8136608420358215693,10.0.2.40,37.157.6.242,443,tcp,tls,130762,12074,38,5012,36,17086,74,normal,-
-7825969889335712760,10.0.2.40,31.30.189.76,443,tcp,tls,346982,476232,384,18239,224,494471,608,normal,-
7020474050885998089,10.0.2.40,147.75.85.234,443,tcp,tls,118118,12730,36,7082,36,19812,72,normal,-
6684009228052122599,10.0.2.40,20.53.203.50,443,tcp,tls,264776,18554,42,4262,44,22816,86,normal,-
269124151945430694,10.0.2.40,52.94.228.167,443,tcp,tls,31670,16078,32,6904,32,22982,64,normal,-
-5927982414597932008,10.0.2.40,178.250.0.157,443,tcp,tls,47578,26004,70,11662,70,37666,140,normal,-
-5821579697339504483,10.0.2.40,178.250.1.8,443,tcp,tls,31061,56684,257,73930,246,130614,503,normal,-
4297713248787181994,10.0.2.40,142.250.27.156,443,tcp,tls,130675,18015,42,4835,42,22850,84,normal,-
4870452287649701407,10.0.2.40,142.251.36.74,443,tcp,tls,223129,164608,182,13541,133,178149,315,normal,-
-3969348650204351853,10.0.2.40,2.16.2.211,443,tcp,tls,12250,9194,24,2684,24,11878,48,normal,-
-2891189158245503298,10.0.2.40,185.235.84.191,443,tcp,tls,22608,9834,31,3918,30,13752,61,normal,-
-2647252467945835323,10.0.2.40,216.239.34.36,443,tcp,tls,1481,25263,60,7614,58,32877,118,normal,-
-2556822732860228208,10.0.2.40,178.79.227.167,443,tcp,tls,72075,1881004,1428,68940,1030,1949944,2458,normal,-
7366384145184955567,10.0.2.40,185.89.211.52,443,tcp,tls,374218,59032,200,48767,241,107799,441,normal,-
-5171906519390597539,10.0.2.40,142.251.36.134,443,tcp,tls,127218,119828,138,9951,101,129779,239,normal,-
7785557007311986597,10.0.2.40,13.226.89.127,443,tcp,tls,193530,13330,30,3428,30,16758,60,normal,-
6730763924812202135,10.0.2.40,188.65.124.66,443,tcp,tls,56137,38675,66,11146,63,49821,129,normal,-
9067517301012156794,10.0.2.40,141.95.98.65,443,tcp,tls,19148,16351,40,4913,40,21264,80,normal,-
652058313149655451,10.0.2.40,91.198.174.192,443,tcp,tls,285029,370722,354,22883,245,393605,599,normal,-
4059101751496861107,10.0.2.40,65.9.95.20,443,tcp,tls,38736,26011,57,8403,55,34414,112,normal,-
7169397169343082523,10.0.2.40,142.251.36.99,443,tcp,tls,216186,78326,121,10919,109,89245,230,normal,-
7142566372802955148,10.0.2.40,23.64.52.128,443,tcp,tls,88034,41440,75,10835,69,52275,144,normal,-
3080994930877182421,10.0.2.40,142.251.36.72,443,tcp,tls,1346,253190,226,11999,136,265189,362,normal,-
-8513060661909341487,10.0.2.40,89.151.5.209,443,tcp,tls,341016,9346,40,3830,36,13176,76,normal,-
4298643014345261773,10.0.2.40,104.18.10.47,443,tcp,tls,185084,17181,51,6682,50,23863,101,normal,-
-7869901030177683053,10.0.2.40,172.67.8.174,443,tcp,tls,10613,43860,270,60904,254,104764,524,normal,-
-8820578174515986319,10.0.2.40,77.75.78.20,443,tcp,tls,520677,51713,98,10430,81,62143,179,normal,-
4393937383065292789,10.0.2.40,23.195.248.244,443,tcp,tls,195570,92018,140,12119,111,104137,251,normal,-
6851641811774438057,10.0.2.40,192.0.76.3,443,tcp,tls,68098,10934,32,4196,32,15130,64,normal,-
1755507697401069189,10.0.2.40,204.79.197.212,443,tcp,tls,173260,10980,30,3686,30,14666,60,normal,-
-1540318962762102871,10.0.2.40,65.9.95.113,443,tcp,tls,139317,24439,65,16608,63,41047,128,normal,-
283341948010296790,10.0.2.40,193.189.143.34,443,tcp,tls,251626,23668,51,5676,54,29344,105,normal,-
-6744379206891936556,10.0.2.40,67.27.213.250,443,tcp,tls,147969,12578,35,4512,38,17090,73,normal,-
-3745840662794067980,10.0.2.40,186.192.81.5,443,tcp,tls,158016,11254,32,3676,34,14930,66,normal,-
-491536534716864983,10.0.2.40,104.96.145.246,443,tcp,tls,134426,10720,32,5114,34,15834,66,normal,-
9205600244504380432,10.0.2.40,142.251.36.65,443,tcp,tls,249384,20296,40,4046,40,24342,80,normal,-
3155298205366124016,10.0.2.40,192.0.72.29,443,tcp,tls,120184,11444,40,3860,38,15304,78,normal,-
8692347618804416838,10.0.2.40,52.94.238.249,443,tcp,tls,29503,36296,173,183225,176,219521,349,normal,-
6235354144421479620,10.0.2.40,152.199.19.160,443,tcp,tls,363372,58462,76,5688,60,64150,136,normal,-
-7059833320597034114,10.0.2.40,104.18.25.185,443,tcp,tls,2633,10180,35,9048,36,19228,71,normal,-
-803260749432402211,10.0.2.40,149.154.167.99,443,tcp,tls,194278,14736,36,3892,38,18628,74,normal,-
-7636236527433366325,10.0.2.40,142.251.36.78,443,tcp,tls,661,24468,39,4542,39,29010,78,normal,-
2379105988584671273,10.0.2.40,13.32.119.187,443,tcp,tls,1363,29268,72,9556,73,38824,145,normal,-
-1428734199481424533,10.0.2.40,3.65.77.204,443,tcp,tls,137532,16884,54,12722,54,29606,108,normal,-
-3062940017911714997,10.0.2.40,192.0.77.2,443,tcp,tls,70651,15271,37,4648,39,19919,76,normal,-
7781427177716055711,10.0.2.40,200.147.35.149,443,tcp,tls,118720,13332,39,5325,41,18657,80,normal,-
-5793525091878656433,10.0.2.40,142.251.37.98,443,tcp,tls,67241,57560,101,12163,92,69723,193,normal,-
-4977989541198251535,10.0.2.40,198.143.164.252,443,tcp,tls,71816,385600,318,19068,246,404668,564,normal,-
3689001714393946461,10.0.2.40,51.89.9.254,443,tcp,tls,60528,10116,36,6582,36,16698,72,normal,-
1806586482844017613,10.0.2.40,52.94.236.248,443,tcp,tls,11732,12898,24,2792,26,15690,50,normal,-
7361481769102535696,10.0.2.40,142.250.27.157,443,tcp,tls,1592,20192,60,6968,55,27160,115,normal,-
-2868412412082574408,10.0.2.40,67.220.228.200,443,tcp,tls,32871,30141,57,13495,57,43636,114,normal,-
6080187049728279595,10.0.2.40,34.248.37.18,443,tcp,tls,2355,5427,15,2583,18,8010,33,normal,-
4929636109904523249,10.0.2.40,69.173.144.138,443,tcp,tls,197314,19179,56,8020,54,27199,110,normal,-
6031105557637852900,10.0.2.40,104.16.86.20,443,tcp,tls,15776,12314,36,4466,34,16780,70,normal,-
455274622853787554,10.0.2.40,188.114.98.236,443,tcp,tls,626,8104,22,2812,22,10916,44,normal,-
841498854064828581,10.0.2.40,185.89.210.141,443,tcp,tls,38457,24060,61,15195,61,39255,122,normal,-
2634348315934684101,10.0.2.40,104.19.188.97,443,tcp,tls,263726,126640,158,11462,108,138102,266,normal,-
-7050494513348701047,10.0.2.40,178.250.0.189,443,tcp,tls,19093,16639,52,7635,49,24274,101,normal,-
6595797232441705201,10.0.2.40,3.33.220.150,443,tcp,tls,120450,10414,40,4562,36,14976,76,normal,-
-3148708417638002216,10.0.2.40,185.152.65.27,443,tcp,tls,149100,473760,370,19840,240,493600,610,normal,-
1013154501492385350,10.0.2.40,104.16.56.101,443,tcp,tls,396941,19281,79,17178,76,36459,155,normal,-
-6201578189418043302,10.0.2.40,65.9.95.111,443,tcp,tls,146156,360470,284,13874,200,374344,484,normal,-
-8226466130384056625,10.0.2.40,54.197.138.12,443,tcp,tls,13205,29791,123,37383,118,67174,241,normal,-
3749361144218170797,10.0.2.40,34.240.23.125,443,tcp,tls,133666,25388,52,11614,46,37002,98,normal,-
-2000192948160108866,10.0.2.40,162.19.138.116,443,tcp,tls,18883,17973,41,5271,39,23244,80,normal,-
7199571780382416698,10.0.2.40,185.80.39.216,443,tcp,tls,12046,61775,113,23497,120,85272,233,normal,-
-5317327350111767203,10.0.2.40,178.250.0.130,443,tcp,tls,53763,213042,206,14338,169,227380,375,normal,-
8691565829532914817,10.0.2.40,147.92.243.206,443,tcp,tls,67921,14481,42,5167,41,19648,83,normal,-
6687528840824132009,10.0.2.40,91.198.174.194,443,tcp,tls,232998,14616,38,4538,38,19154,76,normal,-
-4036085418962584554,10.0.2.40,188.65.124.59,443,tcp,tls,41604,14988,40,21398,40,36386,80,normal,-
-7540415238321500769,10.0.2.40,151.101.194.132,443,tcp,tls,41908,518064,376,13210,202,531274,578,normal,-
-5637833126584530568,10.0.2.40,216.52.2.86,443,tcp,tls,47582,15902,34,5498,34,21400,68,normal,-
2513303365218774787,10.0.2.40,151.101.194.110,443,tcp,tls,263020,12706,42,4080,38,16786,80,normal,-
-1428787725257717886,10.0.2.40,185.235.87.132,443,tcp,tls,21520,10074,35,4240,36,14314,71,normal,-
-7387725928726392521,10.0.2.40,84.17.61.36,443,tcp,tls,111770,102718,92,5392,56,108110,148,normal,-
-6933597889174510436,10.0.2.40,2.16.2.104,443,tcp,tls,23725,309856,294,20504,243,330360,537,normal,-
-6501436465699605969,10.0.2.40,188.65.124.91,443,tcp,tls,31038,13176,26,3614,26,16790,52,normal,-
-1363796417529675376,10.0.2.40,52.94.225.248,443,tcp,tls,166412,15688,42,4450,42,20138,84,normal,-
-6454999168615594777,10.0.2.40,151.101.193.21,443,tcp,tls,168090,18400,42,4860,40,23260,82,normal,-
-5739218401448794098,10.0.2.40,192.229.221.185,443,tcp,tls,342244,18738,48,4294,44,23032,92,normal,-
8183737423560891251,10.0.2.40,37.157.6.254,443,tcp,tls,387576,67954,176,27032,152,94986,328,normal,-
-4404332118973969431,10.0.2.40,87.240.132.67,443,tcp,tls,120398,11742,36,3784,36,15526,72,normal,-
8375062575836396657,10.0.2.40,99.80.224.192,443,tcp,tls,148197,83387,174,41679,170,125066,344,normal,-
-2542202748981923156,10.0.2.40,34.239.220.159,443,tcp,tls,341788,13788,38,4254,40,18042,78,normal,-
5205110685732645659,10.0.2.40,178.250.0.162,443,tcp,tls,20632,9910,36,4320,32,14230,68,normal,-
-3881945401952667183,10.0.2.40,217.20.147.1,443,tcp,tls,60384,13370,32,3490,32,16860,64,normal,-
2229500525034566512,10.0.2.40,65.9.92.135,443,tcp,tls,29180,14646,34,3566,34,18212,68,normal,-
-4454403730920661163,10.0.2.40,95.100.146.40,443,tcp,tls,265772,26520,100,8734,88,35254,188,normal,-
2089021236889320102,10.0.2.40,40.126.32.68,443,tcp,tls,260328,38938,68,7804,58,46742,126,normal,-
-8277675882613613668,10.0.2.40,142.251.37.100,443,tcp,tls,992,21301,55,6470,50,27771,105,normal,-
-1866726603523846949,10.0.2.40,3.126.73.88,443,tcp,tls,18623,19400,41,5963,46,25363,87,normal,-
5301216403551723543,10.0.2.40,104.17.231.204,443,tcp,tls,261342,14464,72,7492,68,21956,140,normal,-
-4162991465812591849,10.0.2.40,93.185.98.100,443,tcp,tls,16526,92502,123,12055,84,104557,207,normal,-
-3384639019450704808,10.0.2.40,151.101.193.108,443,tcp,tls,17754,51752,56,5202,34,56954,90,normal,-
5742945203386873609,10.0.2.40,23.195.249.65,443,tcp,tls,87180,28151,63,7599,61,35750,124,normal,-
1081293527312944942,10.0.2.40,18.193.235.197,443,tcp,tls,5871,12702,27,3006,30,15708,57,normal,-
-4518897201057775098,10.0.2.40,52.97.188.66,443,tcp,tls,173136,12116,34,3676,34,15792,68,normal,-
4946876652741851298,10.0.2.40,23.195.248.219,443,tcp,tls,363854,2209178,1650,49867,704,2259045,2354,normal,-
-7410842474398897206,10.0.2.40,65.9.94.225,443,tcp,tls,13676,21144,43,4959,45,26103,88,normal,-
-8750622808315010105,10.0.2.40,151.101.193.140,443,tcp,tls,393038,19302,72,10350,71,29652,143,normal,-
-7105894953125278314,10.0.2.40,65.9.95.33,443,tcp,tls,39040,26548,59,9414,59,35962,118,normal,-
-7558914287824901781,10.0.2.40,2.16.2.186,443,tcp,tls,80970,9875,55,6599,49,16474,104,normal,-
7068025436542288585,10.0.2.40,104.16.123.96,443,tcp,tls,245992,8894,32,3614,32,12508,64,normal,-
7289289593697994715,10.0.2.40,157.240.20.52,443,tcp,tls,243866,9552,42,4046,40,13598,82,normal,-
5011120429480343812,10.0.2.40,13.107.226.45,443,tcp,tls,249414,10658,30,3516,28,14174,58,normal,-
2254626321431110503,10.0.2.40,77.75.77.222,443,tcp,tls,532508,9162430,6988,320172,2822,9482602,9810,normal,-
761223229510139806,10.0.2.40,162.19.138.83,443,tcp,tls,33924,35179,80,14368,73,49547,153,normal,-
-730752167606321034,10.0.2.40,104.244.42.5,443,tcp,tls,259592,13128,62,12312,64,25440,126,normal,-
-7337994367040059570,10.0.2.40,67.27.213.122,443,tcp,tls,147142,1432234,1008,29392,494,1461626,1502,normal,-
4157430566572544332,10.0.2.40,52.167.30.171,443,tcp,tls,276384,57716,76,9556,62,67272,138,normal,-
2097427590041523630,10.0.2.40,65.9.9.67,443,tcp,tls,245868,14836,38,3938,38,18774,76,normal,-
1007579222766141136,10.0.2.40,54.155.90.90,443,tcp,tls,123720,18418,42,4708,42,23126,84,normal,-
5137981101604851065,10.0.2.40,18.203.152.154,443,tcp,tls,120984,14804,42,4450,40,19254,82,normal,-
2830378668175510299,10.0.2.40,77.75.79.165,443,tcp,tls,492762,15896,60,7196,60,23092,120,normal,-
550991073747678729,10.0.2.40,146.59.30.104,443,tcp,tls,138444,25280,56,5790,50,31070,106,normal,-
-4821106604657284217,10.0.2.40,142.251.37.109,443,tcp,tls,243698,12270,38,4046,40,16316,78,normal,-
-5615281466536757889,10.0.2.40,76.223.111.18,443,tcp,tls,133804,16028,46,6694,42,22722,88,normal,-
6966827567823655803,10.0.2.40,52.29.236.4,443,tcp,tls,132324,16820,46,8346,46,25166,92,normal,-
-7622167650832425247,10.0.2.40,65.9.95.91,443,tcp,tls,240414,15878,42,4792,44,20670,86,normal,-
-4231563481722127574,10.0.2.40,68.219.88.97,443,tcp,tls,369512,16796,50,9314,48,26110,98,normal,-
1433035494690518576,10.0.2.40,104.22.6.216,443,tcp,tls,174218,8842,32,3536,32,12378,64,normal,-
-2131431828393113527,10.0.2.40,64.4.250.36,443,tcp,tls,60650,10548,32,4100,26,14648,58,normal,-
-3057668424688851827,10.0.2.40,18.200.134.47,443,tcp,tls,121860,15766,38,5214,36,20980,74,normal,-
-5435582602288732137,10.0.2.40,65.9.95.63,443,tcp,tls,24180,17448,44,6142,42,23590,86,normal,-
-7820399017137766169,10.0.2.40,8.8.8.8,53,tcp,dns,4340,2796,12,890,12,3686,24,normal,-
6791005941544180760,10.0.2.40,104.18.3.114,443,tcp,tls,116982,12512,38,8404,36,20916,74,normal,-
-1181931522917403905,10.0.2.40,65.9.95.60,443,tcp,tls,146940,26282,50,8410,46,34692,96,normal,-
-6560903847212304228,10.0.2.40,142.251.36.86,443,tcp,tls,256432,13256,36,4368,36,17624,72,normal,-
5673520485027539874,10.0.2.40,65.9.95.96,443,tcp,tls,131200,17776,36,5108,36,22884,72,normal,-
-2685948312800045780,10.0.2.40,104.22.54.206,443,tcp,tls,1057,12268,34,4454,37,16722,71,normal,-
5468846966915830378,10.0.2.40,217.16.188.162,443,tcp,tls,136710,12986,54,11472,54,24458,108,normal,-
-9050942207257193467,10.0.2.40,185.64.189.221,443,tcp,tls,341956,12078,46,6796,42,18874,88,normal,-
-9061078471351671765,10.0.2.40,18.185.10.205,443,tcp,tls,143354,15002,38,4906,40,19908,78,normal,-
-3936815422889017880,10.0.2.40,104.237.62.213,443,tcp,tls,123708,16566,48,5442,38,22008,86,normal,-
6717357030738825107,10.0.2.40,185.59.208.177,443,tcp,tls,145950,1383596,1428,636596,1012,2020192,2440,normal,-
1591943920362894734,10.0.2.40,65.9.95.11,443,tcp,tls,196094,15328,36,3752,36,19080,72,normal,-
9143062276686356194,10.0.2.40,23.195.249.173,443,tcp,tls,276100,827610,689,61104,600,888714,1289,normal,-
-3751244538993673835,10.0.2.40,44.225.221.183,443,tcp,tls,153674,29094,128,40942,126,70036,254,normal,-
1335724267591285232,10.0.2.40,146.75.116.157,443,tcp,tls,260256,14580,72,7840,70,22420,142,normal,-
4696893997702488424,10.0.2.40,151.101.1.164,443,tcp,tls,160894,10756,30,3448,28,14204,58,normal,-
-323616355841309251,10.0.2.40,52.18.161.223,443,tcp,tls,149748,23434,52,7072,54,30506,106,normal,-
-9178246277179448933,10.0.2.40,104.244.42.131,443,tcp,tls,258764,15698,64,12360,66,28058,130,normal,-
-9157707551879136902,10.0.2.40,151.101.192.176,443,tcp,tls,263514,16966,58,6894,58,23860,116,normal,-
-3967956563658004323,10.0.2.40,156.40.212.210,443,tcp,tls,173970,15030,44,4664,46,19694,90,normal,-
-7382373604639698464,10.0.2.40,185.59.208.153,443,tcp,tls,143370,294628,230,13392,204,308020,434,normal,-
1047290474728078794,10.0.2.40,104.17.71.176,443,tcp,tls,260260,97484,100,6294,64,103778,164,normal,-
-2181346530446932725,10.0.2.40,54.149.38.208,443,tcp,tls,915000,9356,38,4926,34,14282,72,normal,-
676848578305994742,10.0.2.40,65.9.95.5,443,tcp,tls,341302,13010,44,4984,44,17994,88,normal,-
1572731367600379992,10.0.2.40,65.9.95.94,443,tcp,tls,38044,15370,36,4956,34,20326,70,normal,-
-203796137919710714,10.0.2.40,65.9.97.56,443,tcp,tls,15030,45172,58,4950,42,50122,100,normal,-
-5823538280321086450,10.0.2.40,65.9.95.22,443,tcp,tls,264804,16936,54,5840,50,22776,104,normal,-
4823006710161594397,10.0.2.40,95.100.146.27,443,tcp,tls,40320,14496,38,3274,28,17770,66,normal,-
-8822359223135750375,10.0.2.40,104.17.210.204,443,tcp,tls,259740,14132,44,4854,40,18986,84,normal,-
1630407292458631798,10.0.2.40,51.105.197.70,443,tcp,tls,120558,10440,38,4340,36,14780,74,normal,-
2115611038864273194,10.0.2.40,188.114.98.236,443,udp,-,554,15579,15,5975,18,21554,33,normal,-
5307170774033092962,10.0.2.40,31.30.189.145,443,udp,-,7098,2508212,2149,86189,692,2594401,2841,normal,-
-8287875715006712004,10.0.2.40,157.240.221.16,443,udp,-,515,10157,22,6316,15,16473,37,normal,-
6630943499943276802,10.0.2.40,104.17.50.95,443,udp,-,107265,43761,109,53388,120,97149,229,normal,-
8196726089992338129,10.0.2.40,142.251.36.73,443,udp,-,818,14384,20,4310,18,18694,38,normal,-
8585843476399197501,10.0.2.40,142.251.36.142,443,udp,-,65205,827995,1054,806110,1021,1634105,2075,normal,-
6131247199183662467,10.0.2.40,216.239.32.36,443,udp,-,137729,115856,303,68260,258,184116,561,normal,-
4039442404595156913,10.0.2.40,13.32.119.187,443,udp,-,1647,30556,40,8484,37,39040,77,normal,-
5753757016499716922,10.0.2.40,142.251.36.100,443,udp,-,115352,345872,673,144883,453,490755,1126,normal,-
9007786551026253824,10.0.2.40,142.251.36.66,443,udp,-,159449,520102,517,53453,242,573555,759,normal,-
-4841404739602397359,10.0.2.40,157.240.30.35,443,udp,-,139963,1222980,1313,288613,681,1511593,1994,normal,-
8564143441952006591,10.0.2.40,142.251.36.106,443,udp,-,3701,113567,138,26383,89,139950,227,normal,-
-4897098939748907899,10.0.2.40,91.189.91.157,123,udp,ntp,274,180,2,180,2,360,4,normal,-
-5975900111422880685,10.0.2.40,142.251.36.78,443,udp,-,80089,111786,171,46626,153,158412,324,normal,-
-4115896648658059143,10.0.2.40,157.240.30.27,443,udp,-,11291,1086080,1008,66428,408,1152508,1416,normal,-
8219590702757759942,10.0.2.40,142.251.36.70,443,udp,-,376,15926,16,3962,14,19888,30,normal,-
6530788703660187047,10.0.2.40,142.251.36.74,443,udp,-,1976,300411,235,15797,84,316208,319,normal,-
3031327395146489394,10.0.2.40,142.251.37.99,443,udp,-,81190,38814,102,22812,82,61626,184,normal,-
-4133188675868170793,10.0.2.40,142.251.37.98,443,udp,-,25399,89727,124,18489,72,108216,196,normal,-
-6165633473325227120,10.0.2.40,31.30.189.76,443,udp,-,2644,2841060,2064,34830,288,2875890,2352,normal,-
8829733585353568163,10.0.2.40,142.251.36.99,443,udp,-,38930,139821,154,19016,106,158837,260,normal,-
-2999223119855881846,10.0.2.40,78.24.11.164,443,tcp,-,12320,6903,23,4325,26,11228,49,normal,-
-3831429646701786697,10.0.2.40,157.240.225.3,443,udp,-,562,13416,23,5594,17,19010,40,normal,-
-6497348077516552612,10.0.2.40,17.253.73.201,80,tcp,http,278192,8218,43,3705,43,11923,86,normal,-
3889836941045052152,10.0.2.40,65.9.92.135,443,udp,-,23246,1797110,1276,51356,422,1848466,1698,normal,-
-6852724245898855847,10.0.2.40,89.151.5.209,443,udp,-,656,13912,20,4676,12,18588,32,normal,-
-2240103779342526831,10.0.2.40,142.251.36.132,443,udp,-,64211,1613140,1883,379596,1008,1992736,2891,normal,-
2037938216849750233,10.0.2.40,157.240.241.1,443,udp,-,764,16738,26,3904,12,20642,38,normal,-
-7580807413194685544,10.0.2.40,142.251.36.65,443,udp,-,478,14974,20,5186,22,20160,42,normal,-
-6209564614167197413,10.0.2.40,172.67.8.174,443,udp,-,34803,62059,173,146991,187,209050,360,normal,-
3283069215425200331,10.0.2.40,142.251.36.97,443,udp,-,35596,2480429,1993,173720,693,2654149,2686,normal,-
6493277028794279302,10.0.2.40,20.112.52.29,80,tcp,-,127551,1504,22,2860,25,4364,47,normal,-
5958049664797667634,10.0.2.40,142.250.27.156,443,udp,-,634,15926,28,6092,18,22018,46,normal,-
-986916051935349683,10.0.2.40,216.239.34.36,443,udp,-,17876,33200,52,12426,53,45626,105,normal,-
-4325156522491984253,10.0.2.40,102.132.100.1,443,udp,-,1749,22778,42,6582,21,29360,63,normal,-
-7807029137911252008,10.0.2.40,104.16.132.229,443,udp,-,284,13308,22,3660,10,16968,32,normal,-
-318680585364667455,10.0.2.40,35.186.249.72,443,udp,-,1140,15478,20,4640,22,20118,42,normal,-
-3160770188646798577,10.0.2.40,142.251.37.109,443,udp,-,2150,275844,240,22633,127,298477,367,normal,-
-2180648324686793495,10.0.2.40,104.17.33.82,443,udp,-,11162,113578,148,23246,84,136824,232,normal,-
-357828641289538299,10.0.2.40,188.184.21.108,80,tcp,-,10688,360,6,472,8,832,14,normal,-
-6617339466603128028,10.0.2.40,142.251.37.100,443,udp,-,13294,52271,54,13815,33,66086,87,normal,-
-3737709671439587728,10.0.2.40,162.159.128.233,443,udp,-,1742,23846,52,46080,56,69926,108,normal,-
9021818185113021336,10.0.2.40,142.250.27.157,443,udp,-,631,11736,16,5157,12,16893,28,normal,-
-5276741775442373580,10.0.2.40,142.251.36.138,443,udp,-,1396,39885,43,8716,34,48601,77,normal,-
6652862616628162575,10.0.2.40,108.138.2.59,443,tcp,-,126,120,2,256,4,376,6,normal,-
-524534942807545620,10.0.2.40,34.98.64.218,443,udp,-,250,10644,10,3630,10,14274,20,normal,-
8949626009708480355,10.0.2.40,157.240.20.52,443,udp,-,608,17210,26,4422,14,21632,40,normal,-
-1610006794588290418,10.0.2.40,178.250.1.11,443,tcp,-,17194,7109,22,2831,24,9940,46,normal,-
-4372517073802182238,10.0.2.40,34.107.204.85,443,udp,-,262622,62592,238,67032,254,129624,492,normal,-
-2578186478765201020,10.0.2.40,179.60.192.7,443,udp,-,471,13425,23,5325,14,18750,37,normal,-
7691441973648338540,10.0.2.40,104.16.86.20,443,udp,-,688,15933,29,5939,20,21872,49,normal,-
-4996746841439498126,10.0.2.40,142.251.37.106,443,udp,-,2951,113239,125,23495,67,136734,192,normal,-
-1912720958816651461,10.0.2.40,104.19.155.83,443,udp,-,170269,49811,102,26931,83,76742,185,normal,-
-9168300604166079756,10.0.2.40,142.251.36.110,443,udp,-,398,14068,16,3974,14,18042,30,normal,-
3918856067772446312,10.0.2.40,91.189.91.49,80,tcp,-,193769,0,0,1554,21,1554,21,normal,-
-2858560785047289458,10.0.2.40,52.97.188.66,443,udp,-,748,50220,52,8652,32,58872,84,normal,-
-5399496904586548474,10.0.2.40,104.18.25.185,443,udp,-,15740,12056,24,10236,18,22292,42,normal,-
-4959830268613630318,10.0.2.40,31.30.189.77,443,udp,-,1086,1843402,1334,27814,268,1871216,1602,normal,-
-1025611896789560140,10.0.2.40,104.22.54.206,443,udp,-,761,24269,32,10314,32,34583,64,normal,-
175508651054376412,10.0.2.40,104.17.49.95,443,udp,-,115296,290646,608,791086,820,1081732,1428,normal,-
3325498833766496895,10.0.2.35,185.125.190.48,80,tcp,http,236,882,10,754,10,1636,20,normal,-
-2453422241480885032,10.0.2.35,147.229.9.226,443,tcp,-,134733,69905,149,20356,141,90261,290,normal,-
6371035725329408084,10.0.2.35,65.9.95.102,443,tcp,tls,170751,19726,47,5100,43,24826,90,normal,-
6362808868416344559,10.0.2.35,77.75.76.101,443,tcp,tls,178029,50475,106,15384,98,65859,204,normal,-
-3624706198287062697,10.0.2.35,141.95.47.56,443,tcp,tls,102276,26681,67,10398,69,37079,136,normal,-
5355927786431894353,10.0.2.35,185.199.111.154,443,tcp,tls,341937,36830,119,14190,119,51020,238,normal,-
728820824132759643,10.0.2.35,77.75.78.104,443,tcp,tls,25681,23157,44,7354,46,30511,90,normal,-
-7799589975000652215,10.0.2.35,77.75.76.30,443,tcp,tls,190200,59885,213,60424,210,120309,423,normal,-
-8537434788773290885,10.0.2.35,77.75.79.195,443,tcp,tls,703902,1125251,1118,71274,899,1196525,2017,normal,-
7310341073685773370,10.0.2.35,34.120.208.123,443,tcp,tls,510524,55854,340,95675,292,151529,632,normal,-
-8633085276922401083,10.0.2.35,185.199.111.133,443,tcp,tls,179722,71665,134,12591,114,84256,248,normal,-
-7143721594448814830,10.0.2.35,77.75.78.157,443,tcp,tls,182148,161392,185,14536,172,175928,357,normal,-
7332521300807296909,10.0.2.35,23.195.248.26,443,tcp,-,61084,28146,68,6805,73,34951,141,normal,-
4142701969690498569,10.0.2.35,95.100.146.66,80,tcp,-,807326,40901,167,24455,175,65356,342,normal,-
-5413935247997715166,10.0.2.35,77.75.78.36,443,tcp,tls,172343,35978,92,12536,89,48514,181,normal,-
-1472663450196169370,10.0.2.35,15.236.125.10,443,tcp,tls,99872,19190,58,10779,57,29969,115,normal,-
-8805370333674774052,10.0.2.35,77.75.78.196,443,tcp,tls,352576,104077,178,30459,156,134536,334,normal,-
-3694451279832915690,10.0.2.35,77.75.78.126,443,tcp,-,84,120,2,256,4,376,6,normal,-
-1316961363654452623,10.0.2.35,104.18.32.68,80,tcp,http,373756,9098,62,6260,67,15358,129,normal,-
7476986511476431239,10.0.2.35,142.251.36.106,443,tcp,tls,498228,83102,316,48140,306,131242,622,normal,-
-4547465620402566240,10.0.2.35,192.0.73.2,443,tcp,tls,34346,44773,99,12059,99,56832,198,normal,-
-8305137923547362016,10.0.2.35,31.13.71.7,443,tcp,tls,1420,11956,30,4256,30,16212,60,normal,-
-7192075342718928060,10.0.2.35,23.195.248.208,443,tcp,tls,40316,10290,30,3206,24,13496,54,normal,-
7324669310180772466,10.0.2.35,157.240.20.19,443,tcp,tls,570,13340,40,4486,34,17826,74,normal,-
3166336244480246825,10.0.2.35,157.240.30.18,443,tcp,tls,19019,70304,176,19856,156,90160,332,normal,-
-8274198649326323593,10.0.2.35,77.75.78.209,443,tcp,tls,55134,12312,28,3134,26,15446,54,normal,-
4835831158376129112,10.0.2.35,104.21.235.45,443,tcp,tls,702,16416,34,4220,32,20636,66,normal,-
7785033733079371512,10.0.2.35,77.75.76.104,443,tcp,tls,18847,41368,90,11608,89,52976,179,normal,-
7529879020764514870,10.0.2.35,157.240.30.27,443,tcp,tls,445686,182346,226,16962,176,199308,402,normal,-
-7825144516584852104,10.0.2.35,142.251.36.65,443,tcp,tls,172527,39356,63,6727,62,46083,125,normal,-
8350308707961399698,10.0.2.35,77.75.77.195,443,tcp,tls,518915,79349,111,9703,114,89052,225,normal,-
2801396159010058019,10.0.2.35,77.75.77.234,443,tcp,tls,930522,87659,152,16430,131,104089,283,normal,-
-6525162352953279675,10.0.2.35,140.82.112.26,443,tcp,tls,72758,10532,48,9014,48,19546,96,normal,-
-7063057041898456037,10.0.2.35,142.251.36.78,443,tcp,tls,2634,49516,64,8340,60,57856,124,normal,-
304401108059109138,10.0.2.35,140.82.121.5,443,tcp,tls,303248,47058,242,169250,240,216308,482,normal,-
7132433772282184590,10.0.2.35,142.251.36.70,443,tcp,tls,171417,19406,56,6600,54,26006,110,normal,-
3100644732461429301,10.0.2.35,109.123.210.246,443,tcp,-,142,120,2,256,4,376,6,normal,-
7818432143519955865,10.0.2.35,142.251.37.118,443,tcp,tls,171854,43051,91,10675,90,53726,181,normal,-
2301966000127895376,10.0.2.35,8.8.8.8,53,udp,dns,1687965,200585,1159,108410,1160,308995,2319,normal,-
8329078303943247420,10.0.2.35,151.101.193.69,443,tcp,tls,2676,33350,75,7785,65,41135,140,normal,-
3481378123572868169,10.0.2.35,146.59.30.96,443,tcp,-,101564,9476,34,3711,33,13187,67,normal,-
-2846090987587607263,10.0.2.35,37.252.171.21,443,tcp,tls,21282,11648,28,4894,24,16542,52,normal,-
2932872766092539169,10.0.2.35,152.195.38.76,80,tcp,-,804948,30072,144,20866,149,50938,293,normal,-
7426022104037632351,10.0.2.35,77.75.79.232,443,tcp,tls,341896,13584,40,4046,40,17630,80,normal,-
6910823668177115732,10.0.2.35,137.254.60.32,443,tcp,-,596,180,3,384,6,564,9,normal,-
6705056178219574606,10.0.2.35,147.229.9.26,443,tcp,-,43804,394934,389,43773,279,438707,668,normal,-
-2756070934848330531,10.0.2.35,77.75.78.54,443,tcp,tls,344506,16454,58,9878,56,26332,114,normal,-
8159466472571365611,10.0.2.35,77.75.79.222,443,tcp,tls,345754,245694,242,18972,170,264666,412,normal,-
5030064304324872099,10.0.2.35,77.77.206.17,443,tcp,tls,1682,12210,36,4480,34,16690,70,normal,-
7411536944485278299,10.0.2.35,77.75.76.20,443,tcp,tls,516469,24889,100,55535,97,80424,197,normal,-
-2868058324335743506,10.0.2.35,104.18.6.29,443,tcp,tls,173417,44349,103,12241,99,56590,202,normal,-
-2917786243929003373,10.0.2.35,217.75.217.17,443,tcp,tls,1002,12440,38,4582,36,17022,74,normal,-
-7224372828061707343,10.0.2.35,31.30.189.145,443,tcp,tls,171328,12597,39,4565,37,17162,76,normal,-
-7933272809344527901,10.0.2.35,188.114.96.3,443,tcp,tls,62145,321433,334,23975,234,345408,568,normal,-
6741625471766010451,10.0.2.35,104.21.0.137,443,tcp,tls,892,8016,20,2704,20,10720,40,normal,-
-8751892523140628486,10.0.2.35,142.251.36.130,443,tcp,tls,527075,107374,237,27548,217,134922,454,normal,-
2425985565395416730,10.0.2.35,142.251.36.74,443,tcp,tls,5715,241481,252,17270,172,258751,424,normal,-
3589938666720139638,10.0.2.35,157.240.30.3,443,tcp,tls,14472,21490,188,77078,154,98568,342,normal,-
-7929579736178774938,10.0.2.35,142.251.36.67,443,tcp,tls,171173,28170,57,6221,53,34391,110,normal,-
30699420358627750,10.0.2.35,70.42.32.63,443,tcp,tls,61058,31653,96,14492,92,46145,188,normal,-
4134463784844352685,10.0.2.35,104.26.4.62,443,tcp,tls,171643,23820,57,6521,52,30341,109,normal,-
2441680215096227653,10.0.2.35,146.75.120.193,443,tcp,tls,172036,23764,54,5688,48,29452,102,normal,-
8082672090541409904,10.0.2.35,142.251.36.72,443,tcp,tls,344924,485087,445,23221,256,508308,701,normal,-
-8264630913267408310,10.0.2.35,182.161.74.16,443,tcp,tls,72782,39501,157,20273,150,59774,307,normal,-
-4241174440467122655,10.0.2.35,142.251.36.102,443,tcp,tls,1436,14554,36,5262,34,19816,70,normal,-
-3116742032370400099,10.0.2.35,185.64.190.81,443,tcp,tls,344416,13038,44,5422,44,18460,88,normal,-
208942847939156190,10.0.2.35,23.195.248.142,443,tcp,tls,310884,92696,213,78446,186,171142,399,normal,-
6041711365041726310,10.0.2.35,185.80.39.216,443,tcp,tls,11916,73845,149,22106,144,95951,293,normal,-
1804021908905326060,10.0.2.35,142.251.37.110,443,tcp,tls,496733,148143,205,17064,153,165207,358,normal,-
-4795539255351050442,10.0.2.35,142.251.36.66,443,tcp,tls,172151,29782,75,8576,71,38358,146,normal,-
-8823011061305550306,10.0.2.35,142.251.36.98,443,tcp,tls,1776,120092,108,5514,58,125606,166,normal,-
4481040338134427184,10.0.2.35,142.251.36.142,443,tcp,tls,866,79938,82,4972,44,84910,126,normal,-
2466140451195554526,10.0.2.35,140.82.121.3,443,tcp,tls,306102,869352,728,54166,656,923518,1384,normal,-
1003438987060602898,10.0.2.35,142.251.36.99,80,tcp,http,992538,28252,157,20427,162,48679,319,normal,-
4272155998135979440,10.0.2.35,34.117.157.22,443,tcp,tls,2180,13372,36,4340,36,17712,72,normal,-
-8453407986956383,10.0.2.35,52.16.166.101,443,tcp,tls,179226,97063,109,11135,67,108198,176,normal,-
-9089052163891651791,10.0.2.35,34.107.221.82,80,tcp,http,526450,5728,69,5758,72,11486,141,normal,-
7627644712780257527,10.0.2.35,62.109.141.196,443,tcp,tls,171683,41561,115,19209,101,60770,216,normal,-
-9200069362280847496,10.0.2.35,23.195.249.210,443,tcp,-,172026,3760820,2894,323190,1188,4084010,4082,normal,-
-821733922839569986,10.0.2.35,142.251.36.97,443,tcp,tls,171667,29592,48,5159,48,34751,96,normal,-
4205970440702341376,10.0.2.35,104.21.235.46,443,tcp,tls,668,12762,24,2920,24,15682,48,normal,-
3555579402828880067,10.0.2.35,172.64.144.98,443,tcp,tls,340732,9780,36,4428,36,14208,72,normal,-
-6359374995792353195,10.0.2.35,142.251.36.68,443,tcp,tls,447013,1187762,1096,87985,676,1275747,1772,normal,-
8485252141208513331,10.0.2.35,23.75.65.175,80,tcp,http,230860,5844,34,2866,36,8710,70,normal,-
4098620923846550054,10.0.2.35,23.195.248.76,443,tcp,tls,416309,634250,1309,436188,1177,1070438,2486,normal,-
-7622849319058339769,10.0.2.35,224.0.0.251,5353,udp,-,0,0,0,366,2,366,2,normal,-
2361627070276453289,10.0.2.35,95.100.146.64,443,tcp,tls,32828,24094,78,11429,71,35523,149,normal,-
-1231253155325516243,10.0.2.35,216.239.34.36,443,tcp,tls,171464,18398,43,4835,42,23233,85,normal,-
8552734990248713160,10.0.2.35,3.126.56.137,443,tcp,tls,161984,34236,100,11985,96,46221,196,normal,-
3838635342001353522,10.0.2.35,151.101.194.137,443,tcp,tls,180130,69432,90,8305,83,77737,173,normal,-
-4362396616697024271,10.0.2.35,178.250.0.147,443,tcp,tls,61756,50149,112,11371,94,61520,206,normal,-
-7915898552872500219,10.0.2.35,77.75.79.129,443,tcp,tls,342970,14068,40,4778,42,18846,82,normal,-
-3008689040355525669,10.0.2.35,95.100.146.50,443,tcp,tls,156757,113971,129,8050,85,122021,214,normal,-
5472153114996722080,10.0.2.35,157.240.30.35,443,tcp,tls,343182,29222,102,11878,92,41100,194,normal,-
2955825595281882400,10.0.2.35,142.251.36.129,443,tcp,tls,706,19262,42,4536,36,23798,78,normal,-
-1760258098353355170,10.0.2.35,91.249.96.148,443,tcp,tls,1130,11610,32,4486,32,16096,64,normal,-
4732841089751452242,10.0.2.35,185.235.84.191,443,tcp,tls,77964,21117,95,12417,90,33534,185,normal,-
-3258323642698081183,10.0.2.35,178.250.0.163,443,tcp,tls,94226,61733,165,22650,152,84383,317,normal,-
-5513804689281198884,10.0.2.35,216.239.32.36,443,tcp,tls,1989,32977,91,11124,84,44101,175,normal,-
9190215436775000510,10.0.2.35,157.240.30.27,443,udp,-,9312,666891,626,42295,270,709186,896,normal,-
-1577227861973588140,10.0.2.35,142.251.36.131,443,tcp,tls,2074,21053,67,7594,53,28647,120,normal,-
17814842853047616,10.0.2.35,157.240.247.8,443,tcp,tls,768,12460,32,4372,30,16832,62,normal,-
3673011512847103303,10.0.2.35,151.101.129.69,443,tcp,tls,344760,177074,184,12250,120,189324,304,normal,-
-2912261426856045407,10.0.2.35,37.157.5.73,443,tcp,tls,60646,77264,78,5382,54,82646,132,normal,-
464702932449820522,10.0.2.35,188.114.97.3,443,tcp,tls,1556,442720,388,25476,338,468196,726,normal,-
6703896612206853583,10.0.2.35,141.95.98.64,443,tcp,tls,51638,46644,103,13492,100,60136,203,normal,-
3028350206785896778,10.0.2.35,140.82.112.21,443,tcp,tls,254430,13126,54,9390,50,22516,104,normal,-
6592489583836585682,10.0.2.35,34.117.237.239,443,tcp,tls,513990,20793,69,7500,71,28293,140,normal,-
1170192115664112047,10.0.2.35,23.195.248.219,443,tcp,tls,408222,7306138,5364,133144,1780,7439282,7144,normal,-
5047149706687771491,10.0.2.35,104.17.32.82,443,tcp,tls,171656,18774,43,4835,42,23609,85,normal,-
-7091556107130142846,10.0.2.35,142.251.36.130,443,udp,-,137996,192140,370,85793,305,277933,675,normal,-
-6402869678099342526,10.0.2.35,185.235.87.41,443,tcp,tls,77801,21213,96,12678,95,33891,191,normal,-
1153887576417681421,10.0.2.35,88.99.113.14,443,tcp,tls,208241,36627,138,78548,137,115175,275,normal,-
1795659814814802200,10.0.2.35,151.101.192.84,443,tcp,tls,183205,31008,73,11093,71,42101,144,normal,-
-8926286877987968986,10.0.2.35,104.64.115.77,443,tcp,-,254327,15124,63,6969,61,22093,124,normal,-
2473786670229448276,10.0.2.35,188.114.97.3,80,tcp,-,242744,3432,38,3034,42,6466,80,normal,-
4616162011292368040,10.0.2.35,142.251.36.129,443,udp,-,1237,22405,31,8091,39,30496,70,normal,-
5573731550181636196,10.0.2.35,185.89.211.116,443,tcp,tls,82004,31949,85,16785,82,48734,167,normal,-
8389608826564517508,10.0.2.35,142.250.27.155,443,tcp,tls,976,13460,38,4538,34,17998,72,normal,-
5637334916767456888,10.0.2.35,69.173.144.165,443,tcp,tls,303726,17478,75,10383,73,27861,148,normal,-
-3335016272081845603,10.0.2.35,95.100.146.16,443,tcp,tls,407705,437147,427,91082,360,528229,787,normal,-
-2628145365330376404,10.0.2.35,3.122.65.194,443,tcp,tls,129280,16028,64,7532,59,23560,123,normal,-
-8082945469535315078,10.0.2.35,192.124.249.41,80,tcp,http,129522,5992,24,2168,24,8160,48,normal,-
-6164808100574366464,10.0.2.35,142.251.36.65,443,udp,-,1728,33126,50,8756,35,41882,85,normal,-
7583988856475723682,10.0.2.35,34.149.215.16,443,tcp,tls,1175,25456,52,6152,52,31608,104,normal,-
8933790763618964766,10.0.2.35,2.16.2.90,443,tcp,tls,348214,7134023,4947,89505,1593,7223528,6540,normal,-
-7043243095366695890,10.0.2.35,104.18.7.29,443,tcp,tls,348,12182,24,2920,24,15102,48,normal,-
-7422787255188228463,10.0.2.35,104.16.89.20,443,tcp,tls,692,60940,66,4546,42,65486,108,normal,-
2340179917734384923,10.0.2.35,35.232.111.17,80,tcp,http,1776,884,10,862,12,1746,22,normal,-
6141376754144912824,10.0.2.35,142.251.36.142,443,udp,-,37524,170223,190,57284,138,227507,328,normal,-
8777481081722854776,10.0.2.35,142.250.27.157,443,tcp,tls,1660,13224,38,4370,34,17594,72,normal,-
3577655789942133991,10.0.2.35,3.126.73.88,443,tcp,tls,58261,19931,74,8382,65,28313,139,normal,-
8985005726191258106,10.0.2.35,157.240.20.19,443,udp,-,298,11300,18,3644,10,14944,28,normal,-
-4699038579781867555,10.0.2.35,142.251.36.68,443,udp,-,125591,1375018,1558,262462,854,1637480,2412,normal,-
-1998634149601058844,10.0.2.35,162.247.243.33,443,tcp,tls,285811,30896,99,24081,98,54977,197,normal,-
-3066419396781949227,10.0.2.35,13.107.21.200,443,tcp,tls,307989,73198,146,19835,144,93033,290,normal,-
-2826043056956281409,10.0.2.35,18.196.162.229,443,tcp,tls,68530,14232,42,5120,42,19352,84,normal,-
-3853468273270713244,10.0.2.35,216.239.32.36,443,udp,-,58822,28305,101,25908,71,54213,172,normal,-
-6089038688419182945,10.0.2.35,23.195.248.81,443,tcp,tls,146063,5170574,3957,266498,1854,5437072,5811,normal,-
-1423761606471042710,10.0.2.35,77.75.79.165,443,tcp,tls,343390,14652,48,5692,48,20344,96,normal,-
7132489531007207720,10.0.2.35,157.240.30.35,443,udp,-,77284,1081648,1152,293906,590,1375554,1742,normal,-
7243076225129941504,10.0.2.35,2.16.2.17,443,tcp,tls,230884,11094,46,4770,46,15864,92,normal,-
6801987751219007540,10.0.2.35,142.251.36.134,443,tcp,tls,1312,44196,56,4926,48,49122,104,normal,-
-56820831651003952,10.0.2.35,185.86.138.154,443,tcp,tls,80425,13217,76,12491,70,25708,146,normal,-
-6901247673627917768,10.0.2.35,142.251.36.86,443,udp,-,688,26984,30,5320,24,32304,54,normal,-
-4016504982820280785,10.0.2.35,34.248.241.151,443,tcp,tls,197540,26169,75,10962,76,37131,151,normal,-
5778290171267555947,10.0.2.35,178.250.0.162,443,tcp,tls,82551,26567,143,18331,131,44898,274,normal,-
-4499743272245545676,10.0.2.35,188.40.16.209,443,tcp,tls,1003749,116581,447,311209,452,427790,899,normal,-
7433809861515889379,10.0.2.35,35.244.145.50,443,tcp,tls,20132,15222,44,6926,44,22148,88,normal,-
4086321981405902370,10.0.2.35,142.251.36.74,443,udp,-,102705,66242,133,37623,122,103865,255,normal,-
-1693001947011355048,10.0.2.35,65.9.9.138,80,tcp,http,525847,18181,90,10859,95,29040,185,normal,-
-2876111552024917682,10.0.2.35,104.96.131.246,80,tcp,http,231606,5934,34,2830,36,8764,70,normal,-
-5311313207951655400,10.0.2.35,151.101.194.27,443,tcp,tls,341576,18154,50,5872,44,24026,94,normal,-
9137322927486916879,10.0.2.35,142.251.36.106,443,udp,-,61893,108675,135,25444,106,134119,241,normal,-
3464358324915811700,10.0.2.35,142.251.37.110,443,udp,-,137808,349288,446,83109,313,432397,759,normal,-
-2488178285562964302,10.0.2.35,23.195.248.158,443,tcp,tls,240504,52108,72,5424,54,57532,126,normal,-
-6169011158417040439,10.0.2.35,13.224.189.98,443,tcp,tls,10314,1678,16,2236,18,3914,34,normal,-
2115486843905866557,10.0.2.35,95.100.146.24,443,tcp,tls,29721,343455,291,22894,267,366349,558,normal,-
2423578535386460216,10.0.2.35,54.155.90.90,443,tcp,tls,156362,26024,73,10607,70,36631,143,normal,-
6234675869160810981,10.0.2.35,192.229.221.185,443,tcp,tls,17414,17778,34,3490,32,21268,66,normal,-
-958193657536712474,10.0.2.35,178.250.1.11,443,tcp,tls,73732,21704,108,13767,100,35471,208,normal,-
2226411388732243830,10.0.2.35,104.87.145.13,443,tcp,tls,22792,28156,54,5746,55,33902,109,normal,-
-4648435914346637816,10.0.2.35,20.119.174.243,443,tcp,tls,17048,15474,40,14114,42,29588,82,normal,-
-563017688754834015,10.0.2.35,35.186.249.72,443,tcp,tls,26560,15408,32,3566,34,18974,66,normal,-
252935850945933358,10.0.2.35,162.247.243.29,443,tcp,tls,763747,33889,212,89804,212,123693,424,normal,-
-3881224245385750875,10.0.2.35,95.100.146.40,443,tcp,tls,60736,7952,40,4973,37,12925,77,normal,-
-3267805255162368847,10.0.2.35,104.17.33.82,443,tcp,tls,341336,9180,36,3830,36,13010,72,normal,-
-4511983101977612928,10.0.2.35,178.250.0.157,443,tcp,tls,89065,36191,160,22323,152,58514,312,normal,-
-7429690977916639055,10.0.2.35,52.35.3.113,443,tcp,tls,1018374,9054,34,4818,32,13872,66,normal,-
-8760136841169987895,10.0.2.35,142.251.36.83,443,tcp,tls,343150,212038,184,7260,88,219298,272,normal,-
-39376498622706410,10.0.2.35,65.9.95.26,443,tcp,tls,494800,63246,136,17692,128,80938,264,normal,-
-8866369984617353537,10.0.2.35,81.95.110.170,443,tcp,tls,305456,10022,51,6264,53,16286,104,normal,-
7869231732735212238,10.0.2.35,178.250.1.9,443,tcp,tls,41126,15182,70,10450,68,25632,138,normal,-
4559771374303484276,10.0.2.35,65.9.97.248,443,tcp,tls,341298,43914,64,5740,62,49654,126,normal,-
-8136684364226092161,10.0.2.35,54.73.101.116,443,tcp,tls,495392,18450,66,7512,68,25962,134,normal,-
-8985717064275484584,10.0.2.35,152.199.19.160,443,tcp,tls,20870,57754,66,4560,42,62314,108,normal,-
-6078008932010608010,10.0.2.35,23.195.249.173,443,tcp,tls,45285,95218,140,14764,101,109982,241,normal,-
-8227942547475289693,10.0.2.35,20.190.159.64,443,tcp,tls,18902,26650,38,4957,32,31607,70,normal,-
8887666978528584791,10.0.2.35,37.252.173.215,443,tcp,tls,72822,32457,94,15677,87,48134,181,normal,-
8163597498023063100,10.0.2.35,104.64.175.239,443,tcp,tls,497916,19222,92,12428,94,31650,186,normal,-
-3250760176323674303,10.0.2.35,141.226.228.48,443,tcp,tls,287603,19364,78,9845,74,29209,152,normal,-
7025099190507720221,10.0.2.35,37.157.6.233,443,tcp,tls,719643,75304,175,28354,157,103658,332,normal,-
-8561584089638403408,10.0.2.35,142.251.36.86,443,tcp,tls,340730,13022,36,3938,38,16960,74,normal,-
-608942208205233016,10.0.2.35,104.18.43.158,443,tcp,tls,181090,9736,36,4242,34,13978,70,normal,-
591794564137069107,10.0.2.35,185.255.84.153,443,tcp,tls,120609,21632,85,10187,83,31819,168,normal,-
6914230999329389994,10.0.2.35,13.107.226.44,443,tcp,tls,65306,48200,94,10416,88,58616,182,normal,-
-8795166750641753944,10.0.2.35,35.157.87.32,443,tcp,tls,122434,14750,40,4910,42,19660,82,normal,-
-8716881556063710493,10.0.2.35,34.117.202.77,443,tcp,tls,343226,60461,90,7956,78,68417,168,normal,-
-6448920210772287994,10.0.2.35,142.251.36.136,443,tcp,tls,117400,18484,45,5064,45,23548,90,normal,-
6358612804072847190,10.0.2.35,76.223.111.18,443,tcp,tls,498818,18194,68,7750,66,25944,134,normal,-
-2767934981185697057,10.0.2.35,52.182.143.210,443,tcp,tls,15907,38364,141,73249,136,111613,277,normal,-
-5845236084805003110,10.0.2.35,13.107.43.14,443,tcp,tls,18722,16236,44,6193,44,22429,88,normal,-
8194259843033021320,10.0.2.35,35.244.143.131,443,tcp,tls,342378,124021,126,7800,88,131821,214,normal,-
-2168372720477353291,10.0.2.35,2.16.2.193,443,tcp,tls,12008,8956,20,2576,22,11532,42,normal,-
-8025696044655775654,10.0.2.35,65.9.94.207,443,tcp,tls,510250,25224,96,19104,96,44328,192,normal,-
-2815564169101808494,10.0.2.35,68.219.88.97,443,tcp,tls,19456,19740,46,8229,44,27969,90,normal,-
641629584117409736,10.0.2.35,8.8.8.8,53,tcp,dns,4210,2904,14,998,14,3902,28,normal,-
-2315419236527402205,10.0.2.35,52.167.30.171,443,tcp,tls,29214,57440,74,8570,50,66010,124,normal,-
3580530728124234273,10.0.2.35,52.49.84.227,443,tcp,tls,498470,16604,72,8066,72,24670,144,normal,-
7251429800923212660,10.0.2.35,185.152.65.26,443,tcp,tls,75460,17609,77,9025,74,26634,151,normal,-
4324007629075493761,10.0.2.35,95.100.146.34,443,tcp,tls,695327,557295,519,38932,445,596227,964,normal,-
1088732429294926343,10.0.2.35,65.9.95.75,443,tcp,tls,342724,35278,52,4762,44,40040,96,normal,-
-2066438535710933543,10.0.2.35,95.100.146.83,443,tcp,tls,230802,11334,50,4770,46,16104,96,normal,-
-8774991952829491843,10.0.2.35,37.157.6.234,443,tcp,tls,90732,13516,47,5319,44,18835,91,normal,-
6317591143126729666,10.0.2.35,84.17.61.35,443,tcp,tls,512587,40269,71,7189,65,47458,136,normal,-
-1484178511027115970,10.0.2.35,13.37.25.97,443,tcp,tls,61442,10842,32,6472,34,17314,66,normal,-
969592369793797016,10.0.2.35,34.72.37.10,443,tcp,tls,380664,10896,50,7876,50,18772,100,normal,-
4890117918400787924,10.0.2.35,35.190.43.134,443,tcp,tls,173208,20531,56,7021,57,27552,113,normal,-
5729500344065512028,10.0.2.35,54.173.252.237,443,tcp,tls,342630,17906,54,9726,56,27632,110,normal,-
-9220028055153451785,10.0.2.35,2.16.2.187,443,tcp,tls,29536,9862,32,3422,28,13284,60,normal,-
1384105793711663468,10.0.2.35,65.9.95.87,443,tcp,tls,341414,15744,40,4588,40,20332,80,normal,-
9044621299099287671,10.0.2.35,2.16.2.74,443,tcp,tls,232102,11216,46,4776,46,15992,92,normal,-
1949470660811008112,10.0.2.35,23.195.248.244,443,tcp,tls,10050,19893,43,5101,41,24994,84,normal,-
3575495158871320030,10.0.2.35,18.198.57.16,443,tcp,tls,497886,29308,78,9566,80,38874,158,normal,-
-5701508666163502328,10.0.2.35,23.195.248.24,443,tcp,tls,498290,28200,80,8154,78,36354,158,normal,-
7749475187751366467,10.0.2.35,52.7.211.131,443,tcp,tls,498572,19878,80,8318,80,28196,160,normal,-
3448767115037887638,10.0.2.35,185.64.189.110,443,tcp,tls,498700,19968,70,8536,70,28504,140,normal,-
-7132474518951875440,10.0.2.35,65.9.94.123,443,tcp,tls,126617,21705,50,5153,53,26858,103,normal,-
8900166214955073999,10.0.2.35,34.193.254.183,443,tcp,tls,29800,13472,36,3854,36,17326,72,normal,-
-5079768622325722467,10.0.2.35,23.195.249.65,443,tcp,tls,498820,21362,84,8404,86,29766,170,normal,-
6748193529974314281,10.0.2.35,13.107.238.44,443,tcp,tls,20778,12740,30,3594,30,16334,60,normal,-
5809719088584928531,10.0.2.35,95.100.146.11,443,tcp,tls,249956,226246,194,8872,106,235118,300,normal,-
-6363898705917948932,10.0.2.35,142.251.36.138,443,tcp,tls,341854,12886,36,3938,38,16824,74,normal,-
-3739145008627937840,10.0.2.35,3.132.205.45,443,tcp,tls,490122,24594,72,7246,70,31840,142,normal,-
308850387346131821,10.0.2.35,18.158.7.247,443,tcp,tls,76400,19028,64,6836,56,25864,120,normal,-
5110183544350622521,10.0.2.35,52.17.243.237,443,tcp,tls,25846,16696,34,4392,30,21088,64,normal,-
-5090358512321850655,10.0.2.35,23.195.248.203,443,tcp,tls,241350,54386,82,5824,60,60210,142,normal,-
8271604381032511973,10.0.2.35,52.58.30.104,443,tcp,tls,499562,27198,105,11484,97,38682,202,normal,-
-6644801507536876376,10.0.2.35,31.13.71.7,443,udp,-,808,16742,26,4060,14,20802,40,normal,-
-8703735567157656072,10.0.2.35,142.251.36.72,443,udp,-,20504,562948,450,28233,162,591181,612,normal,-
-1257449827918517733,10.0.2.35,217.75.217.17,443,udp,-,288,10482,16,3816,12,14298,28,normal,-
83108554036897500,10.0.2.35,142.251.36.131,443,udp,-,59156,27767,96,22876,72,50643,168,normal,-
6496167574386614752,10.0.2.35,104.21.235.45,443,udp,-,5804,48536,72,9946,44,58482,116,normal,-
2125039348460306162,10.0.2.35,188.114.97.3,443,udp,-,1228,432672,394,61658,182,494330,576,normal,-
-7056545140053224853,10.0.2.35,34.117.202.77,443,udp,-,21600,35848,56,9218,46,45066,102,normal,-
-3135202839340564802,10.0.2.35,142.251.36.66,443,udp,-,3081,36107,53,13326,42,49433,95,normal,-
-5762450839177742823,10.0.2.35,104.16.89.20,443,udp,-,681,13941,30,7332,21,21273,51,normal,-
-6269243320168289298,10.0.2.35,142.251.36.67,443,udp,-,95258,1326758,1071,67028,431,1393786,1502,normal,-
8792770188292670230,10.0.2.35,142.251.36.70,443,udp,-,584,11829,17,5492,16,17321,33,normal,-
-6272936393334042261,10.0.2.35,188.114.96.3,443,udp,-,51537,13525401,11275,448575,2812,13973976,14087,normal,-
-8592147814666044656,10.0.2.35,35.244.143.131,443,udp,-,49390,33903,93,34245,89,68148,182,normal,-
886161793502497869,10.0.2.35,131.253.33.203,80,tcp,http,16630,5234,12,1666,14,6900,26,normal,-
-6139110349310585106,10.0.2.35,20.112.52.29,80,tcp,-,17687,540,9,708,12,1248,21,normal,-
-8396798831134548468,10.0.2.35,142.250.27.155,443,udp,-,8092,18526,36,7871,27,26397,63,normal,-
-4788583794761802354,10.0.2.35,142.251.36.136,443,udp,-,655,164676,135,10073,49,174749,184,normal,-
5932492414146465080,10.0.2.35,34.117.157.22,443,udp,-,814,12436,19,6914,15,19350,34,normal,-
6550454334411273564,10.0.2.35,35.190.43.134,443,udp,-,22708,16110,36,9292,32,25402,68,normal,-
-5564036412051221703,10.0.2.35,31.30.189.145,443,udp,-,7706,173650,182,15056,74,188706,256,normal,-
8462324167229493180,10.0.2.35,142.251.36.134,443,udp,-,22170,47964,42,5536,28,53500,70,normal,-
6690400720335357739,10.0.2.35,77.77.206.17,443,udp,-,372,10476,16,3658,10,14134,26,normal,-
429083260684969397,10.0.2.35,216.239.34.36,443,udp,-,88064,48076,127,29664,111,77740,238,normal,-
-7803617884205541571,10.0.2.35,192.229.221.95,80,tcp,http,232326,3510,32,2724,34,6234,66,normal,-
-9202418801223342294,10.0.2.35,34.149.215.16,443,udp,-,398,12034,14,3808,12,15842,26,normal,-
8643486278373945714,10.0.2.35,65.9.95.17,80,tcp,-,126671,1780,22,1750,25,3530,47,normal,-
838602493170915654,10.0.2.35,142.251.36.97,443,udp,-,546,22626,24,4886,22,27512,46,normal,-
-1607468839151883207,10.0.2.35,104.17.33.82,443,udp,-,5204,50490,80,21302,68,71792,148,normal,-
9094146277526375019,10.0.2.35,35.244.145.50,443,udp,-,20057,20753,25,6992,23,27745,48,normal,-
-5402720625887970397,10.0.2.35,142.251.36.78,443,udp,-,6960,166254,216,44530,134,210784,350,normal,-
-7162674645295064666,10.0.2.35,142.251.36.98,443,udp,-,366,14470,16,4134,16,18604,32,normal,-
-6703274064832900416,10.0.2.35,74.125.128.127,19302,udp,-,144,148,2,124,2,272,4,normal,-
8401961887776496091,10.0.2.35,104.21.0.137,443,udp,-,246,17677,20,5924,17,23601,37,normal,-
4826672660490732465,10.0.2.35,157.240.30.18,443,udp,-,260,11300,18,3734,12,15034,30,normal,-
8698731058981976694,10.0.2.35,162.159.137.232,443,udp,-,4507,35629,81,72506,95,108135,176,normal,-
-161970301861013788,10.0.2.35,157.240.225.3,443,udp,-,370,11318,18,4002,14,15320,32,normal,-
-8008926575976211200,10.0.2.35,142.250.27.157,443,udp,-,386,4524,8,3258,6,7782,14,normal,-
1678151258863533256,10.0.2.35,157.240.247.8,443,udp,-,534,19636,32,4552,18,24188,50,normal,-
-2580838024456637015,10.0.2.35,142.251.36.102,443,udp,-,22918,24350,46,25936,46,50286,92,normal,-
-99921682342869530,10.0.2.35,91.249.96.148,443,udp,-,328,10480,16,3654,10,14134,26,normal,-
1097318727255651625,10.0.2.35,35.186.249.72,443,udp,-,1114,15658,22,4636,22,20294,44,normal,-
4179719551369525963,10.0.2.43,142.251.36.142,443,tcp,tls,91781,2055277,1535,57652,822,2112929,2357,normal,-
-6665219492682850153,10.0.2.43,142.251.36.138,443,tcp,tls,2220,27342,114,17823,113,45165,227,normal,-
-6289045148442295161,10.0.2.43,142.251.36.86,443,tcp,tls,11599,329013,302,17337,201,346350,503,normal,-
6069714938564506863,10.0.2.43,65.9.95.102,443,tcp,tls,171385,21152,47,5125,44,26277,91,normal,-
-582414518554117908,10.0.2.43,77.75.78.30,443,tcp,tls,540451,276219,519,135887,505,412106,1024,normal,-
-7656639642949297833,10.0.2.43,142.251.37.99,443,tcp,tls,632384,1205494,1125,67087,741,1272581,1866,normal,-
-6550472120109442059,10.0.2.43,142.251.36.98,443,tcp,tls,180446,48258,115,12694,109,60952,224,normal,-
554350678906267728,10.0.2.43,77.75.77.195,443,tcp,tls,1198964,542423,583,36806,398,579229,981,normal,-
-8863864058827669999,10.0.2.43,34.120.208.123,443,tcp,tls,744245,61447,339,87947,285,149394,624,normal,-
-9106691120439675273,10.0.2.43,77.75.78.196,443,tcp,-,351699,73158,130,20037,113,93195,243,normal,-
-9063702428161453269,10.0.2.43,2.16.2.112,443,tcp,tls,40552,114350,102,4396,36,118746,138,normal,-
-8929247450405677390,10.0.2.43,37.157.2.247,443,tcp,tls,94425,824003,636,26104,363,850107,999,normal,-
-7450180390178748297,10.0.2.43,23.73.140.46,443,tcp,tls,101235,63403,121,12109,112,75512,233,normal,-
-3631280456297388387,10.0.2.43,35.232.111.17,80,tcp,http,638,884,10,754,10,1638,20,normal,-
-7445042381213716051,10.0.2.43,77.75.78.157,443,tcp,tls,357831,25411,83,9391,80,34802,163,normal,-
-4157178334435600180,10.0.2.43,142.251.36.74,443,tcp,tls,361653,72742,172,18828,168,91570,340,normal,-
1141437569010636361,10.0.2.43,142.251.37.100,443,tcp,tls,342399,53218,96,9575,88,62793,184,normal,-
-8389171399434071857,10.0.2.43,77.75.76.104,443,tcp,tls,27023,47523,98,12583,95,60106,193,normal,-
427500037367858422,10.0.2.43,77.75.78.104,443,tcp,tls,57628,92858,122,19740,111,112598,233,normal,-
-8838755575538192106,10.0.2.43,77.75.79.195,443,tcp,tls,876252,1898917,1667,90388,1275,1989305,2942,normal,-
-4125201559885761620,10.0.2.43,142.251.36.99,80,tcp,-,1166708,24941,184,19345,196,44286,380,normal,-
8092373279723544351,10.0.2.43,77.75.76.30,443,tcp,tls,404,12728,26,3028,26,15756,52,normal,-
1163590333346364499,10.0.2.43,146.59.30.100,443,tcp,tls,100910,13681,43,4883,39,18564,82,normal,-
-4018092563038776948,10.0.2.43,224.0.0.251,5353,udp,-,0,0,0,366,2,366,2,normal,-
-3926026985051963918,10.0.2.43,141.95.47.56,443,tcp,tls,646,8766,24,2964,22,11730,46,normal,-
-6512831144390075139,10.0.2.43,95.100.146.72,80,tcp,http,1468811,57201,262,34917,274,92118,536,normal,-
6500666964454106319,10.0.2.43,142.251.36.134,443,tcp,tls,10584,31399,76,9041,78,40440,154,normal,-
7181380216164360963,10.0.2.43,142.251.36.97,443,tcp,tls,172715,58149,101,10717,98,68866,199,normal,-
-603402013685779606,10.0.2.43,104.26.11.240,443,tcp,tls,646,35220,68,6064,50,41284,118,normal,-
4922205692491076189,10.0.2.43,142.251.36.106,443,tcp,tls,4737,317883,459,46610,330,364493,789,normal,-
8635347809612452806,10.0.2.43,77.75.76.101,443,tcp,tls,691950,51120,172,29356,162,80476,334,normal,-
5472867254633958674,10.0.2.43,77.75.78.209,443,tcp,tls,76743,182283,175,10002,119,192285,294,normal,-
3332863028186448729,10.0.2.43,8.8.8.8,53,udp,dns,2156943,178688,1119,102513,1123,281201,2242,normal,-
1502701122140424839,10.0.2.43,142.251.37.110,443,tcp,tls,1108280,107565,223,25923,212,133488,435,normal,-
5073935100206166266,10.0.2.43,77.75.77.234,443,tcp,tls,341810,14724,42,6308,40,21032,82,normal,-
6831112985517283369,10.0.2.43,142.251.36.70,443,tcp,tls,171109,20173,57,6409,53,26582,110,normal,-
6361423196046642931,10.0.2.43,185.89.210.212,443,tcp,tls,21038,11748,30,5110,28,16858,58,normal,-
2726343934288363002,10.0.2.43,77.75.79.232,443,tcp,tls,341914,22888,74,10093,72,32981,146,normal,-
-441766422137616017,10.0.2.43,15.236.125.10,443,tcp,tls,61340,12198,36,5588,36,17786,72,normal,-
5831167351087782048,10.0.2.43,77.75.79.129,443,tcp,tls,512975,16492,63,7210,62,23702,125,normal,-
3478048387715442656,10.0.2.43,65.9.95.45,443,tcp,tls,341646,12794,40,4768,40,17562,80,normal,-
-6466128887339267685,10.0.2.43,142.251.36.65,443,udp,-,7049,72730,90,18150,74,90880,164,normal,-
3163037538150910479,10.0.2.43,142.251.37.110,443,udp,-,86985,1039389,1053,303878,656,1343267,1709,normal,-
-7396724050790588593,10.0.2.43,142.250.27.157,443,tcp,tls,888,13570,40,4646,36,18216,76,normal,-
4132710266722762587,10.0.2.43,151.101.65.69,443,tcp,tls,185844,148642,192,15794,151,164436,343,normal,-
8595590655523168306,10.0.2.43,157.240.30.18,443,tcp,tls,177331,16767,74,10957,72,27724,146,normal,-
1056934402324706034,10.0.2.43,104.26.11.240,443,udp,-,1424,2302496,1956,51058,366,2353554,2322,normal,-
-5688191696563679860,10.0.2.43,205.185.208.142,443,tcp,tls,172722,185042,202,16098,166,201140,368,normal,-
848777334725065537,10.0.2.43,77.75.79.165,443,tcp,tls,343260,14760,50,5800,50,20560,100,normal,-
6845447029179498482,10.0.2.43,64.210.135.113,443,tcp,tls,32265,180944,206,15558,140,196502,346,normal,-
-7945066266473330082,10.0.2.43,192.0.73.2,443,tcp,tls,33016,43821,99,11565,92,55386,191,normal,-
-8126465303349753325,10.0.2.43,142.251.36.65,443,tcp,tls,172943,49033,76,8295,76,57328,152,normal,-
-8053622078310661897,10.0.2.43,142.251.36.110,443,udp,-,35418,96539,139,22789,103,119328,242,normal,-
-8762668188028165070,10.0.2.43,77.75.76.20,443,tcp,tls,516153,24469,93,53343,94,77812,187,normal,-
353370878526559563,10.0.2.43,142.251.36.99,443,udp,-,62793,176844,195,30672,140,207516,335,normal,-
-1106786298374111924,10.0.2.43,185.66.189.51,443,tcp,tls,514505,19516,81,14695,77,34211,158,normal,-
2805485277053854616,10.0.2.43,185.66.189.42,443,tcp,tls,513519,38289,80,8630,72,46919,152,normal,-
-8430617991956099828,10.0.2.43,23.195.248.219,443,tcp,tls,322748,2077287,1565,53778,739,2131065,2304,normal,-
6046436971115790474,10.0.2.43,146.75.120.193,443,tcp,tls,172560,33403,75,7492,64,40895,139,normal,-
-4890135704098956419,10.0.2.43,142.251.36.98,443,udp,-,1602,35670,53,12575,44,48245,97,normal,-
8233261214679083383,10.0.2.43,216.239.32.36,443,tcp,tls,12760,26721,77,9406,71,36127,148,normal,-
2801773985021122001,10.0.2.43,142.251.37.100,443,udp,-,17348,242308,412,122943,287,365251,699,normal,-
8695601625998598375,10.0.2.43,185.64.190.89,443,tcp,tls,341430,11754,40,6592,38,18346,78,normal,-
-6194284406151048166,10.0.2.43,17.253.73.205,80,tcp,http,216442,6070,32,2650,32,8720,64,normal,-
-6479353581944520239,10.0.2.43,142.251.36.130,443,tcp,tls,629745,29219,90,10192,91,39411,181,normal,-
-4628708732431809521,10.0.2.43,142.251.36.86,443,udp,-,9974,389345,310,15689,93,405034,403,normal,-
-7639870107709543701,10.0.2.43,23.203.124.192,443,tcp,tls,244672,41326,62,5398,48,46724,110,normal,-
8865028525032693929,10.0.2.43,34.117.237.239,443,tcp,tls,511818,20955,72,7662,74,28617,146,normal,-
-5996303226938812193,10.0.2.43,142.251.37.99,443,udp,-,8131,56941,78,25808,72,82749,150,normal,-
-1376432363953133086,10.0.2.43,141.95.47.55,443,tcp,tls,308952,62417,125,23066,121,85483,246,normal,-
-5237026141712444715,10.0.2.43,209.197.3.25,443,tcp,tls,16157,17373,37,4134,38,21507,75,normal,-
8017147757498052019,10.0.2.43,77.75.77.69,443,tcp,tls,340776,13682,42,4154,42,17836,84,normal,-
4268381476216701311,10.0.2.43,31.13.72.12,443,tcp,tls,1082,12696,38,4364,32,17060,70,normal,-
4119036371454193033,10.0.2.43,37.157.5.142,443,tcp,tls,246144,32492,82,11356,74,43848,156,normal,-
8161003380464591959,10.0.2.43,142.251.36.134,443,udp,-,1072,23909,36,7850,34,31759,70,normal,-
199496254798389378,10.0.2.43,192.229.221.95,80,tcp,http,1025646,31434,177,22520,186,53954,363,normal,-
5518673256271237558,10.0.2.43,142.251.36.132,443,tcp,tls,171126,18887,52,6115,50,25002,102,normal,-
-9051546744261861940,10.0.2.43,157.240.200.14,443,tcp,tls,1044,13180,36,4364,32,17544,68,normal,-
8743134752286020485,10.0.2.43,62.4.252.209,443,tcp,tls,1206,12100,36,4582,36,16682,72,normal,-
-6816513222695543544,10.0.2.43,34.107.221.82,80,tcp,http,527058,5728,69,5758,72,11486,141,normal,-
-910873418193822295,10.0.2.43,66.254.114.38,443,tcp,tls,61268,20954,53,8602,51,29556,104,normal,-
-3995772066597816911,10.0.2.43,77.75.78.126,443,tcp,tls,512650,15423,57,5951,56,21374,113,normal,-
-1618282150419353844,10.0.2.43,104.18.32.68,80,tcp,http,461946,7300,64,5448,68,12748,132,normal,-
7410478398111635432,10.0.2.43,198.47.127.20,443,tcp,tls,343978,13146,46,5530,46,18676,92,normal,-
-1532573942090417464,10.0.2.43,216.239.34.36,443,tcp,tls,172176,26078,73,8627,69,34705,142,normal,-
5228364536477990647,10.0.2.43,142.251.36.129,443,tcp,tls,738,19260,42,4536,36,23796,78,normal,-
8994184072549189487,10.0.2.43,91.189.91.157,123,udp,ntp,386,180,2,180,2,360,4,normal,-
5840055967380011603,10.0.2.43,142.251.36.142,443,udp,-,61559,309906,536,249148,468,559054,1004,normal,-
-3141396306801606919,10.0.2.43,77.75.78.36,443,tcp,tls,343918,19290,64,11176,60,30466,124,normal,-
9142982979688236241,10.0.2.43,31.30.189.205,443,tcp,tls,348833,255080,233,15046,159,270126,392,normal,-
8491449401527769009,10.0.2.43,142.251.36.70,443,udp,-,510,18352,20,6275,22,24627,42,normal,-
-8091533041972033465,10.0.2.43,142.251.36.72,443,tcp,tls,343813,233791,228,13204,146,246995,374,normal,-
-4672106828060003971,10.0.2.43,89.249.13.145,443,tcp,tls,1034,12424,36,4476,34,16900,70,normal,-
-491161187588075395,10.0.2.43,77.75.77.222,443,tcp,tls,528214,359538,356,28485,243,388023,599,normal,-
5639880980664947565,10.0.2.43,2.16.2.99,443,tcp,tls,40384,2078,26,3274,26,5352,52,normal,-
2782768532660184804,10.0.2.43,142.251.37.98,443,tcp,tls,341496,12586,36,3830,36,16416,72,normal,-
-1126619938008829915,10.0.2.43,41.21.237.145,443,tcp,tls,2450,11796,38,4724,36,16520,74,normal,-
5225784765917603563,10.0.2.43,185.175.85.74,443,tcp,tls,13867,1358316,968,29316,450,1387632,1418,normal,-
2754206061666925339,10.0.2.43,205.185.208.20,443,tcp,tls,27474,148789,146,10505,94,159294,240,normal,-
-4897664642019419358,10.0.2.43,157.240.30.35,443,tcp,tls,510800,14997,61,5961,58,20958,119,normal,-
-4919536401522819813,10.0.2.43,23.195.248.208,443,tcp,tls,243574,33342,62,6088,60,39430,122,normal,-
8841716632174846603,10.0.2.43,142.251.36.97,443,udp,-,1300,60012,67,13331,44,73343,111,normal,-
-405620510235941455,10.0.2.43,146.59.30.96,443,tcp,tls,202416,9712,36,3914,34,13626,70,normal,-
3653468116957093941,10.0.2.43,66.254.114.41,443,tcp,tls,92859,143474,148,11273,99,154747,247,normal,-
6582542108501561829,10.0.2.43,142.251.36.106,443,udp,-,933,25404,40,13007,43,38411,83,normal,-
-707402307791374429,10.0.2.43,205.185.208.79,443,tcp,tls,170976,19345,43,4781,41,24126,84,normal,-
-561186189615761315,10.0.2.43,68.183.77.227,443,tcp,tls,986389,848726,880,79142,633,927868,1513,normal,-
6047741066032800041,10.0.2.43,66.254.114.171,443,tcp,tls,121144,32328,58,9366,50,41694,108,normal,-
1905497359974375000,10.0.2.43,142.251.36.66,443,tcp,tls,419025,23084,54,5760,55,28844,109,normal,-
4886372106633530850,10.0.2.43,185.64.190.81,443,tcp,tls,341514,13146,46,5314,42,18460,88,normal,-
4931477657872483578,10.0.2.43,151.101.193.69,443,tcp,tls,542,13340,30,3114,26,16454,56,normal,-
3288617879955238417,10.0.2.43,157.240.30.3,443,tcp,tls,3624,16190,112,26552,94,42742,206,normal,-
2876546598935116588,10.0.2.43,77.75.76.36,443,tcp,tls,343440,18204,52,10420,50,28624,102,normal,-
3747284388408207551,10.0.2.43,157.240.252.13,443,tcp,tls,596,12936,36,4366,32,17302,68,normal,-
1791527104161412601,10.0.2.43,65.9.95.5,443,tcp,tls,341440,5032,36,4592,36,9624,72,normal,-
-5865357198816122924,10.0.2.43,31.30.189.145,443,udp,-,5414,1377343,1147,37984,272,1415327,1419,normal,-
-3885899992873006371,10.0.2.43,37.252.171.52,443,tcp,tls,20642,11634,28,5250,28,16884,56,normal,-
6933428872456394071,10.0.2.43,185.125.190.49,80,tcp,http,359,1323,15,1131,15,2454,30,normal,-
6890627369144440179,10.0.2.43,142.251.36.112,443,tcp,tls,341624,12010,34,3830,36,15840,70,normal,-
-6431196625961547825,10.0.2.43,142.251.36.72,443,udp,-,18536,890713,703,36058,256,926771,959,normal,-
-7705899648660568460,10.0.2.43,77.75.78.20,443,tcp,tls,342446,17484,76,52348,74,69832,150,normal,-
-7643424678010829735,10.0.2.43,31.30.189.205,443,udp,-,584,605728,438,13794,114,619522,552,normal,-
7228558233999613649,10.0.2.43,157.240.30.27,443,tcp,tls,340985,172504,175,9754,110,182258,285,normal,-
-3350071497486429431,10.0.2.43,37.157.3.30,443,tcp,tls,247970,47402,112,15656,100,63058,212,normal,-
5928717892227186951,10.0.2.43,31.13.72.12,443,udp,-,398,11130,16,3828,12,14958,28,normal,-
-3237328226008933718,10.0.2.43,157.240.30.35,443,udp,-,49305,978565,1031,212026,458,1190591,1489,normal,-
127762473920068176,10.0.2.43,216.239.34.36,443,udp,-,69245,33838,161,35927,109,69765,270,normal,-
7179009672281723198,10.0.2.43,142.251.36.132,443,udp,-,82271,188783,483,97724,376,286507,859,normal,-
3565833775984860640,10.0.2.43,142.251.36.66,443,udp,-,38347,43004,73,15343,49,58347,122,normal,-
-8043272905413045491,10.0.2.43,62.4.252.209,443,udp,-,588,10484,16,3656,10,14140,26,normal,-
-2496841918425114540,10.0.2.43,142.251.36.74,443,udp,-,8629,122005,146,24428,102,146433,248,normal,-
-4819017165934034599,10.0.2.43,142.251.36.130,443,udp,-,8198,29092,60,16489,49,45581,109,normal,-
7945128027387943347,10.0.2.43,13.107.226.44,443,tcp,-,738188,156168,194,16523,156,172691,350,normal,-
-5736387634780102953,10.0.2.43,142.250.27.157,443,udp,-,580,14434,16,3972,14,18406,30,normal,-
2052600700978787626,10.0.2.43,20.119.174.243,443,tcp,tls,156676,83271,483,529692,485,612963,968,normal,-
4388025785101974804,10.0.2.43,95.100.146.24,443,tcp,tls,20919,24826,53,6247,53,31073,106,normal,-
-2008949337471620675,10.0.2.43,2.16.2.195,443,tcp,tls,33820,1311936,951,29748,458,1341684,1409,normal,-
1733870818835641651,10.0.2.43,142.251.36.67,443,udp,-,49666,42811,114,27311,96,70122,210,normal,-
-8707095590844401579,10.0.2.43,52.168.112.66,443,tcp,tls,492705,61304,184,82750,189,144054,373,normal,-
-2750207508938261237,10.0.2.43,23.195.248.244,443,tcp,-,124056,154978,144,9822,123,164800,267,normal,-
8888894650010099289,10.0.2.43,157.240.30.27,443,udp,-,4962,2596474,2138,53024,437,2649498,2575,normal,-
-5621200215767304277,10.0.2.43,13.107.21.200,443,tcp,tls,303690,51707,135,18747,134,70454,269,normal,-
7317751919327278189,10.0.2.43,77.75.79.69,443,tcp,tls,340442,13574,40,4126,38,17700,78,normal,-
6888700952488476287,10.0.2.43,142.251.36.129,443,udp,-,358,14446,16,4140,16,18586,32,normal,-
8211396925641460367,10.0.2.43,13.107.42.14,443,tcp,tls,211826,66165,147,18644,141,84809,288,normal,-
533716478001655725,10.0.2.43,41.21.237.145,443,udp,-,1578,18804,30,4442,18,23246,48,normal,-
-5615143543206768095,10.0.2.43,23.195.249.173,443,tcp,tls,186835,371762,365,25355,244,397117,609,normal,-
-3011770412049518331,10.0.2.43,89.249.13.145,443,udp,-,418,10488,16,3650,10,14138,26,normal,-
8828906212825740529,10.0.2.43,142.251.36.78,443,tcp,tls,503308,44902,95,9868,92,54770,187,normal,-
2940911289009806357,10.0.2.43,157.240.221.16,443,udp,-,694,14266,24,5004,16,19270,40,normal,-
368171244367056562,10.0.2.43,185.64.189.221,443,tcp,tls,342214,11862,42,6696,40,18558,82,normal,-
4443104948670670444,10.0.2.43,142.251.37.98,443,udp,-,44667,68156,147,30572,101,98728,248,normal,-
-645247302732895126,10.0.2.43,217.75.217.17,443,tcp,tls,340534,9238,38,3830,36,13068,74,normal,-
1280574872999320717,10.0.2.43,157.240.221.16,443,tcp,tls,342156,9704,36,3830,36,13534,72,normal,-
5407620804418693191,10.0.2.43,157.240.252.13,443,udp,-,264,11304,18,3654,10,14958,28,normal,-
1015089113277590514,10.0.2.43,217.75.217.17,443,udp,-,608,14102,20,4980,16,19082,36,normal,-
-8190817002175897670,10.0.2.43,157.240.30.18,443,udp,-,992,12866,24,4774,18,17640,42,normal,-
-7391210328251376300,10.0.2.43,157.240.200.14,443,udp,-,428,11320,18,3748,12,15068,30,normal,-
-2497672905109222834,10.0.2.43,204.79.197.203,80,tcp,http,202681,8865,35,3255,35,12120,70,normal,-
-8553146443019982593,10.0.2.43,216.239.32.36,443,udp,-,21386,71121,153,35219,136,106340,289,normal,-
-2365272136610888212,10.0.2.43,2.16.2.211,443,tcp,tls,11012,9192,24,2684,24,11876,48,normal,-
1937010122192431324,10.0.2.43,65.9.95.115,443,tcp,tls,340832,16098,46,4864,44,20962,90,normal,-
5785821617572949332,10.0.2.43,142.251.36.109,443,tcp,tls,6553,365359,297,13638,167,378997,464,normal,-
-8398108501773989105,10.0.2.43,188.185.10.243,443,tcp,tls,1525,79240,78,7532,73,86772,151,normal,-
2685174670912297413,10.0.2.43,2.16.2.194,443,tcp,tls,244872,11116246,7670,138958,2476,11255204,10146,normal,-
-1135128972228279035,10.0.2.43,104.244.42.69,443,tcp,tls,420035,15884,69,9951,68,25835,137,normal,-
-3116884955866709715,10.0.2.43,68.219.88.97,443,tcp,tls,348920,25657,67,11290,64,36947,131,normal,-
-4870200055512757255,10.0.2.43,52.167.30.171,443,tcp,tls,249718,36204,54,6402,40,42606,94,normal,-
7266557634094515809,10.0.2.43,188.185.87.101,80,tcp,http,17371,1383,13,816,14,2199,27,normal,-
-8063567751324031074,10.0.2.43,104.244.42.131,443,tcp,tls,341594,10014,42,5162,42,15176,84,normal,-
549438180555606026,10.0.2.43,52.19.200.27,443,tcp,tls,183945,25749,63,7724,66,33473,129,normal,-
4986518062590747152,10.0.2.43,104.26.2.11,443,tcp,tls,3010,28311,72,9572,72,37883,144,normal,-
3253674955658879693,10.0.2.43,65.9.95.82,443,tcp,tls,106476,33151392,22738,267770,4826,33419162,27564,normal,-
-1306965537483926077,10.0.2.43,142.251.36.99,443,tcp,tls,1942,28606,64,7833,63,36439,127,normal,-
-7383204076791837081,10.0.2.43,146.75.120.157,443,tcp,tls,341664,44640,66,5362,52,50002,118,normal,-
188170466213256795,10.0.2.43,142.251.37.106,443,tcp,tls,92458,54131,131,14855,123,68986,254,normal,-
-864338475519735236,10.0.2.43,35.186.249.72,443,tcp,tls,512412,24311,61,6630,63,30941,124,normal,-
54376415898619766,10.0.2.43,142.251.37.97,443,tcp,tls,506,11170,22,2920,24,14090,46,normal,-
1290471756938926266,10.0.2.43,65.9.95.61,443,tcp,tls,29646,14229,54,10450,54,24679,108,normal,-
6366711586942277439,10.0.2.43,152.199.19.161,443,tcp,tls,341914,31846,56,5122,48,36968,104,normal,-
6085285609788209021,10.0.2.43,104.17.50.95,443,tcp,tls,174425,29321,87,10619,87,39940,174,normal,-
7932730593828777244,10.0.2.43,65.9.95.108,443,tcp,tls,161872,16078,46,5304,44,21382,90,normal,-
5045130840599531402,10.0.2.43,157.240.30.54,443,tcp,tls,78058,33483,99,11516,91,44999,190,normal,-
-7186789131639822118,10.0.2.43,200.147.3.157,443,tcp,tls,11628,8390,20,3052,22,11442,42,normal,-
6593816891915032237,10.0.2.43,65.9.94.151,443,tcp,tls,55300,50201,108,12691,118,62892,226,normal,-
73534402825156011,10.0.2.43,142.251.36.67,443,tcp,tls,174922,23735,59,6896,57,30631,116,normal,-
-6237659494003279291,10.0.2.43,104.21.235.46,443,tcp,tls,19968,19427,40,4702,40,24129,80,normal,-
7108370099572237359,10.0.2.43,104.21.235.45,443,tcp,tls,4674,16524,36,4248,34,20772,70,normal,-
-4177341594008499910,10.0.2.43,104.91.71.23,443,tcp,tls,40558,10376,32,3166,26,13542,58,normal,-
4808862757585721300,10.0.2.43,52.17.243.237,443,tcp,tls,126794,20824,46,6238,44,27062,90,normal,-
-2753005651265854687,10.0.2.43,87.240.132.78,443,tcp,tls,92800,11040,28,3382,30,14422,58,normal,-
6322439570648802976,10.0.2.43,17.253.144.10,443,tcp,tls,596,17712,36,4984,33,22696,69,normal,-
-4918174963957250019,10.0.2.43,34.107.204.85,443,tcp,tls,80560,18177,41,4904,44,23081,85,normal,-
4783413617147083775,10.0.2.43,65.9.95.66,443,tcp,tls,91162,13024,28,3350,30,16374,58,normal,-
-824996340298560562,10.0.2.43,65.9.95.16,443,tcp,tls,92544,14870,30,3350,30,18220,60,normal,-
4755386667317244061,10.0.2.43,149.154.167.99,443,tcp,tls,92224,14322,30,3490,32,17812,62,normal,-
-2464807062457384160,10.0.2.43,65.9.95.49,443,tcp,tls,200850,114648,184,14808,142,129456,326,normal,-
4082618569460448397,10.0.2.43,91.198.174.208,443,tcp,tls,65740,39462,81,9462,75,48924,156,normal,-
-203951741741430646,10.0.2.43,104.16.124.175,443,tcp,tls,105253,204635,183,10311,116,214946,299,normal,-
-2984417996940006088,10.0.2.43,104.19.187.97,443,tcp,tls,242571,15774,64,7586,62,23360,126,normal,-
-114339465106941725,10.0.2.43,172.67.74.164,443,tcp,tls,202290,56730,210,32184,184,88914,394,normal,-
-3609780515552719588,10.0.2.43,130.117.76.5,443,tcp,tls,43452,19900,52,5816,50,25716,102,normal,-
1000798583843525017,10.0.2.43,172.64.144.98,443,tcp,tls,58272,9492,32,4056,32,13548,64,normal,-
-2093729195869530447,10.0.2.43,91.198.174.192,443,tcp,tls,65301,115778,126,9453,98,125231,224,normal,-
-5090602593082118890,10.0.2.43,65.9.9.138,80,tcp,http,509542,9751,70,6748,75,16499,145,normal,-
-7675075735840115319,10.0.2.43,13.32.121.119,443,tcp,tls,206078,1968796,1405,42384,683,2011180,2088,normal,-
-5237266283921088162,10.0.2.43,104.19.154.83,443,tcp,tls,235255,11962,42,4980,42,16942,84,normal,-
1534997699411541632,10.0.2.43,192.229.221.185,443,tcp,tls,341490,18498,44,4186,42,22684,86,normal,-
-996245241921532886,10.0.2.43,54.239.28.85,443,tcp,tls,11800,12790,22,2684,24,15474,46,normal,-
-1476406707454674375,10.0.2.43,151.101.193.140,443,tcp,tls,238340,18506,65,8840,62,27346,127,normal,-
-4583220188438729316,10.0.2.43,142.250.102.154,443,tcp,tls,1994,13790,40,5074,38,18864,78,normal,-
-4636299950736165298,10.0.2.43,65.9.95.42,443,tcp,tls,423077,29877,73,8440,73,38317,146,normal,-
3088978731794156425,10.0.2.43,157.240.20.52,443,tcp,tls,484,9370,34,4064,30,13434,64,normal,-
-6598194141577028489,10.0.2.43,104.17.25.14,443,tcp,tls,3366,39226,64,5732,54,44958,118,normal,-
7387690908167929072,10.0.2.43,142.251.36.68,443,tcp,tls,1263,12918,35,4516,36,17434,71,normal,-
-1608685304189642628,10.0.2.43,95.100.146.40,443,tcp,tls,162412,22672,64,6386,62,29058,126,normal,-
8914770609053829851,10.0.2.43,151.101.194.110,443,tcp,tls,160056,13246,42,4618,38,17864,80,normal,-
5360471253125522723,10.0.2.43,44.240.21.97,443,tcp,tls,81782,12726,46,12832,44,25558,90,normal,-
-4815389133613808680,10.0.2.43,65.9.95.23,443,tcp,tls,160204,15944,38,4630,40,20574,78,normal,-
7787343552854846140,10.0.2.43,18.211.121.97,443,tcp,tls,342754,14086,42,5004,40,19090,82,normal,-
-5386257158156058831,10.0.2.43,20.112.52.29,443,tcp,tls,161296,18314,38,3968,40,22282,78,normal,-
8287370602352721080,10.0.2.43,104.16.56.101,443,tcp,tls,163092,8758,30,3428,30,12186,60,normal,-
1163796486533108802,10.0.2.43,146.75.116.157,443,tcp,tls,157262,13198,56,6330,54,19528,110,normal,-
-8285624263776659619,10.0.2.43,142.251.36.81,443,tcp,tls,5292,18644,58,10100,52,28744,110,normal,-
6828385641918674628,10.0.2.43,147.67.34.45,443,tcp,tls,10664,7680,16,2222,18,9902,34,normal,-
2732472252200340792,10.0.2.43,65.9.95.112,443,tcp,tls,340542,15888,44,4940,44,20828,88,normal,-
-3739501553575966048,10.0.2.43,104.244.42.195,443,tcp,tls,155928,13368,50,9464,50,22832,100,normal,-
6367420325283036697,10.0.2.43,54.149.242.38,443,tcp,tls,1731932,9344,38,4996,34,14340,72,normal,-
1905750858063009916,10.0.2.43,104.26.3.11,443,tcp,tls,204530,2544684,1790,52866,914,2597550,2704,normal,-
9051021586253673608,10.0.2.43,34.254.107.23,443,tcp,tls,341722,14384,48,12746,48,27130,96,normal,-
2706622446218312593,10.0.2.43,65.9.95.11,443,tcp,tls,91984,15130,34,3566,34,18696,68,normal,-
6343973842027798707,10.0.2.43,65.9.94.226,443,tcp,tls,205438,78834,80,5046,48,83880,128,normal,-
-1095309447004003152,10.0.2.43,104.16.57.101,443,tcp,tls,81137,15075,66,20476,63,35551,129,normal,-
8600223216866499780,10.0.2.43,142.251.36.136,443,tcp,tls,341852,12800,36,3830,36,16630,72,normal,-
-2644306164618168513,10.0.2.43,104.17.213.204,443,tcp,tls,157836,12080,34,4310,34,16390,68,normal,-
580326883815702486,10.0.2.43,104.16.89.20,443,tcp,tls,1542,27178,42,4152,34,31330,76,normal,-
5384076910760579758,10.0.2.43,104.17.68.176,443,tcp,tls,157808,53220,64,4828,46,58048,110,normal,-
-1001624257340444123,10.0.2.43,95.100.146.59,443,tcp,tls,40632,10266,30,3058,24,13324,54,normal,-
-7187922308475047010,10.0.2.43,172.64.154.85,443,tcp,tls,157860,11284,34,4140,32,15424,66,normal,-
238434072981476276,10.0.2.43,2.16.2.209,443,tcp,tls,180801,19716,66,7181,56,26897,122,normal,-
7625428176137485301,10.0.2.43,20.190.159.0,443,tcp,tls,232582,24704,54,5378,50,30082,104,normal,-
5624300740346356637,10.0.2.43,34.251.201.224,443,tcp,tls,43156,29280,52,4854,44,34134,96,normal,-
8989754657368150870,10.0.2.43,104.17.231.204,443,tcp,tls,157542,12834,54,6202,54,19036,108,normal,-
3536506429420748002,10.0.2.43,162.159.128.233,443,udp,-,2444,23108,60,48842,76,71950,136,normal,-
1827143082908451018,10.0.2.43,35.167.176.94,443,tcp,tls,77512,30724,152,56114,150,86838,302,normal,-
-996698685167091974,10.0.2.43,142.250.102.157,443,udp,-,847,9268,35,7556,20,16824,55,normal,-
-8186184440832566196,10.0.2.43,142.251.36.136,443,udp,-,334,87038,72,4928,22,91966,94,normal,-
8768706515582722999,10.0.2.43,104.21.235.45,443,udp,-,306,6736,14,3738,10,10474,24,normal,-
4749315147804642065,10.0.2.43,157.240.20.52,443,udp,-,470,9984,23,5272,14,15256,37,normal,-
-7957501444873325447,10.0.2.43,142.251.36.78,443,udp,-,15439,112491,121,19468,94,131959,215,normal,-
7745622025798694661,10.0.2.43,104.17.50.95,443,udp,-,70227,318587,460,348514,421,667101,881,normal,-
-3576929867910602522,10.0.2.43,104.19.154.83,443,udp,-,111534,41062,85,18749,57,59811,142,normal,-
9048027324178414712,10.0.2.43,142.251.36.68,443,udp,-,111508,2363846,2355,314021,987,2677867,3342,normal,-
-2574638821288963187,10.0.2.43,188.114.97.3,443,udp,-,1996,232800,218,18780,96,251580,314,normal,-
-8475276817384502234,10.0.2.43,142.251.36.67,80,tcp,-,191619,9052,46,6657,50,15709,96,normal,-
-6625287847766173979,10.0.2.43,142.251.36.81,443,udp,-,691,23482,24,5958,21,29440,45,normal,-
-4577323077992793651,10.0.2.43,104.21.235.46,443,udp,-,3388,52376,88,14332,64,66708,152,normal,-
4383303201836768980,10.0.2.43,104.18.21.226,80,tcp,http,91424,5046,20,2120,22,7166,42,normal,-
6705467256610017042,10.0.2.43,157.240.30.54,443,udp,-,6358,126169,140,19890,75,146059,215,normal,-
-3801721670648037968,10.0.2.43,44.236.48.31,443,tcp,tls,151472,13146,42,4632,42,17778,84,normal,-
6579714035464748387,10.0.2.43,142.251.36.118,443,udp,-,3440,83330,100,13164,78,96494,178,normal,-
7446158033583434972,10.0.2.43,142.251.36.109,443,udp,-,1452,22725,29,5916,21,28641,50,normal,-
2240663299826188126,10.0.2.43,104.16.89.20,443,udp,-,696,10564,18,3664,10,14228,28,normal,-
1848506882223742435,10.0.2.43,142.251.37.106,443,udp,-,1106,22706,28,12700,34,35406,62,normal,-
795997940490750404,10.0.2.43,35.186.249.72,443,udp,-,700,13968,14,3798,14,17766,28,normal,-
1499824351725904266,10.0.2.43,188.185.10.243,80,tcp,http,120832,1462,20,1946,20,3408,40,normal,-
8218464983249302938,10.0.2.43,188.184.21.108,80,tcp,-,10574,360,6,472,8,832,14,normal,-
-2657035101177577614,10.0.2.43,142.250.102.157,443,tcp,-,312,120,2,256,4,376,6,normal,-
-2877777796194345373,10.0.2.43,104.18.20.226,80,tcp,http,92806,4992,20,2104,22,7096,42,normal,-
-2922883772428243676,10.0.2.43,142.250.102.154,443,udp,-,874,15778,14,3808,12,19586,26,normal,-
-196684876222310997,10.0.2.43,192.124.249.23,80,tcp,http,92136,5752,20,2060,22,7812,42,normal,-
-3257838547946764379,10.0.2.43,34.107.204.85,443,udp,-,97516,47992,174,47618,186,95610,360,normal,-
-4937857725566542849,10.0.2.43,104.17.25.14,443,udp,-,1158,33822,42,4878,18,38700,60,normal,-
-3404764260053972926,10.0.2.43,142.251.36.73,443,udp,-,496,14048,16,3972,14,18020,30,normal,-
-1378442541132043768,10.0.2.61,77.75.79.195,443,tcp,tls,349312,201636,235,17641,177,219277,412,normal,-
691620087464049476,10.0.2.61,77.75.76.30,443,tcp,tls,360701,67756,244,66384,237,134140,481,normal,-
-4431440478062049071,10.0.2.61,23.195.248.208,443,tcp,tls,40556,10170,28,3206,24,13376,52,normal,-
-7901075475973301115,10.0.2.61,77.75.76.104,443,tcp,tls,14361,27019,56,7046,55,34065,111,normal,-
-1605225303283450227,10.0.2.61,77.75.77.195,443,tcp,tls,582920,499231,570,43606,472,542837,1042,normal,-
15270653192432287,10.0.2.61,77.75.78.157,443,tcp,tls,179648,35423,87,10104,88,45527,175,normal,-
9220030886597461334,10.0.2.61,77.75.78.104,443,tcp,tls,23177,23100,43,7375,46,30475,89,normal,-
-2529511907207217574,10.0.2.61,77.75.79.232,443,tcp,tls,171418,17780,37,4123,39,21903,76,normal,-
-4252044995994235623,10.0.2.61,37.252.171.85,443,tcp,tls,31600,17696,44,7187,38,24883,82,normal,-
-2172388655781504228,10.0.2.61,142.251.36.129,443,tcp,tls,753,25330,51,5168,44,30498,95,normal,-
3389351238500758908,10.0.2.61,142.251.37.99,443,tcp,tls,456030,49923,141,17199,139,67122,280,normal,-
5599765560093170372,10.0.2.61,142.251.36.86,443,tcp,tls,158002,56934,173,20555,168,77489,341,normal,-
-4599606224812955572,10.0.2.61,185.199.111.154,443,tcp,tls,343848,40223,104,12428,105,52651,209,normal,-
6503495654218032865,10.0.2.61,142.251.36.102,443,tcp,tls,935,21613,54,7288,50,28901,104,normal,-
-3685499661609929143,10.0.2.61,185.199.108.133,443,tcp,tls,180007,47136,120,13134,111,60270,231,normal,-
8096265953112059579,10.0.2.61,54.236.198.240,443,tcp,tls,118686,52674,115,17479,120,70153,235,normal,-
3943744442062135451,10.0.2.61,192.0.73.2,443,tcp,tls,33020,48164,105,12105,98,60269,203,normal,-
5175721822156600563,10.0.2.61,185.199.109.133,443,tcp,tls,414,10084,26,3028,26,13112,52,normal,-
2919525578100303416,10.0.2.61,142.251.36.65,443,tcp,tls,325055,59273,98,10426,98,69699,196,normal,-
-2478547499768418686,10.0.2.61,142.251.36.106,443,tcp,tls,43898,30782,133,21204,129,51986,262,normal,-
-201609358617464558,10.0.2.61,151.101.1.69,443,tcp,tls,173219,53560,122,12831,108,66391,230,normal,-
-1646378086033526935,10.0.2.61,77.75.78.196,443,tcp,-,346471,67240,118,18884,100,86124,218,normal,-
3425389219351336462,10.0.2.61,104.64.115.77,443,tcp,tls,60780,15362,43,4749,39,20111,82,normal,-
7934882247551732983,10.0.2.61,23.195.248.26,443,tcp,tls,182025,100300,201,19345,180,119645,381,normal,-
1973134284533044632,10.0.2.61,151.101.65.69,443,tcp,tls,176551,156797,171,11615,125,168412,296,normal,-
-4511902238060238230,10.0.2.61,142.251.36.74,443,tcp,-,456145,28161,83,9071,85,37232,168,normal,-
1529381709331362746,10.0.2.61,216.239.34.36,443,tcp,tls,213479,39423,109,13404,103,52827,212,normal,-
-4595267915205640259,10.0.2.61,185.66.189.42,443,tcp,-,299640,130791,171,13780,126,144571,297,normal,-
5983906326951473963,10.0.2.61,151.101.193.140,443,tcp,tls,903286,2596651,2270,229920,2094,2826571,4364,normal,-
-3757872805303789629,10.0.2.61,157.240.30.27,443,tcp,tls,1873,174823,188,12446,126,187269,314,normal,-
-7816877476317460389,10.0.2.61,178.250.1.9,443,tcp,tls,20916,11508,36,4394,34,15902,70,normal,-
6791950666419513870,10.0.2.61,142.251.36.66,443,tcp,tls,174191,74618,180,22914,176,97532,356,normal,-
-770544641871544106,10.0.2.61,37.157.6.247,443,tcp,tls,122229,22356,55,6952,53,29308,108,normal,-
2042289851692413697,10.0.2.61,142.251.36.136,443,tcp,tls,171601,215870,198,11110,124,226980,322,normal,-
-696930383665908498,10.0.2.61,104.18.7.29,443,tcp,tls,173066,51438,114,13907,115,65345,229,normal,-
2077414444438366723,10.0.2.61,77.75.76.101,443,tcp,tls,14989,54510,70,5550,52,60060,122,normal,-
-5991257658483749497,10.0.2.61,142.251.36.130,443,tcp,tls,221932,66464,143,18130,137,84594,280,normal,-
616394565238557144,10.0.2.61,77.75.77.69,443,tcp,tls,176705,19978,53,6572,53,26550,106,normal,-
4779563045030531862,10.0.2.61,142.251.36.100,443,tcp,-,574363,59101,172,20403,171,79504,343,normal,-
-3195382375851717574,10.0.2.61,142.251.36.80,443,tcp,tls,836,14944,34,4246,34,19190,68,normal,-
-2131404010059662091,10.0.2.61,172.64.155.188,80,tcp,http,765526,14998,109,10568,115,25566,224,normal,-
-375159922152651846,10.0.2.61,81.95.110.170,443,tcp,-,78,120,2,256,4,376,6,normal,-
-1371215552020725678,10.0.2.61,13.37.25.97,443,tcp,tls,61590,12200,36,5590,36,17790,72,normal,-
-801738390118540990,10.0.2.61,205.185.208.142,443,tcp,tls,172744,122636,169,14205,129,136841,298,normal,-
-4222758027858184418,10.0.2.61,91.228.74.244,443,tcp,tls,550,8954,24,2898,22,11852,46,normal,-
3270864456120955546,10.0.2.61,142.251.37.98,443,tcp,tls,693491,44441,125,14200,122,58641,247,normal,-
-5091628989309643270,10.0.2.61,142.251.36.99,80,tcp,http,1496325,40028,237,29259,245,69287,482,normal,-
8857158865760511201,10.0.2.61,104.26.5.62,443,tcp,tls,172004,44674,70,6456,54,51130,124,normal,-
2291017150673638125,10.0.2.61,64.210.135.117,443,tcp,tls,16470,9144,28,3098,22,12242,50,normal,-
-6398236006390635007,10.0.2.61,37.157.6.235,443,tcp,tls,61228,18292,46,5120,43,23412,89,normal,-
-2278488097739936485,10.0.2.61,35.224.170.84,80,tcp,http,626,884,10,862,12,1746,22,normal,-
7533016404927989217,10.0.2.61,178.250.1.11,443,tcp,tls,34352,17566,52,7171,51,24737,103,normal,-
-3445513928349086017,10.0.2.61,35.186.224.17,443,tcp,tls,3108,28013,88,14679,78,42692,166,normal,-
9201570497911658114,10.0.2.61,17.253.73.205,80,tcp,http,219330,6178,34,2758,34,8936,68,normal,-
8336174482035414078,10.0.2.61,146.75.122.251,443,tcp,tls,2679,2278820,1613,58160,996,2336980,2609,normal,-
-2648399229579238229,10.0.2.61,141.226.228.48,443,tcp,tls,122740,11516,40,4506,36,16022,76,normal,-
-5728226580083531786,10.0.2.61,8.8.8.8,53,tcp,dns,4186,2904,14,998,14,3902,28,normal,-
-4241821449837348851,10.0.2.61,142.250.27.156,443,tcp,tls,1162,13492,38,4658,36,18150,74,normal,-
4843944397810625389,10.0.2.61,77.75.76.54,443,tcp,tls,342074,14558,42,6720,44,21278,86,normal,-
-5920260803727796953,10.0.2.61,185.235.84.53,443,tcp,tls,20874,10124,36,4114,34,14238,70,normal,-
8319684666608195465,10.0.2.61,104.17.33.82,443,tcp,tls,342532,23278,60,6912,63,30190,123,normal,-
-1645448976487917600,10.0.2.61,5.101.109.44,443,tcp,tls,100412,9092,32,3350,30,12442,62,normal,-
-7254354450693765454,10.0.2.61,140.82.112.25,443,tcp,tls,106266,11018,54,9550,56,20568,110,normal,-
-4926825990850541511,10.0.2.61,77.75.78.101,443,tcp,tls,551613,116172,197,25484,156,141656,353,normal,-
-5155263688215621230,10.0.2.61,77.75.79.129,443,tcp,tls,343894,14308,44,4886,44,19194,88,normal,-
-7806373702495436330,10.0.2.61,146.59.30.96,443,tcp,tls,101577,13621,42,5207,45,18828,87,normal,-
-6729383161177561752,10.0.2.61,142.251.36.141,443,tcp,tls,1993,272266,235,12731,171,284997,406,normal,-
-2049446466797797410,10.0.2.61,18.193.246.45,443,tcp,tls,61386,13986,40,4618,38,18604,78,normal,-
-4318199094477393037,10.0.2.61,69.173.144.165,443,tcp,tls,153706,9784,38,4362,36,14146,74,normal,-
8019252079934699306,10.0.2.61,35.186.224.25,443,tcp,tls,175240,45468,120,15447,114,60915,234,normal,-
5913950960750497749,10.0.2.61,77.75.78.20,443,tcp,tls,516272,23306,82,31210,82,54516,164,normal,-
2759801637264544792,10.0.2.61,142.251.36.118,443,tcp,tls,4602,100500,100,5838,54,106338,154,normal,-
1428153020566245654,10.0.2.61,142.251.36.78,443,tcp,tls,1460,171099,164,9428,95,180527,259,normal,-
-397380026845474435,10.0.2.61,216.18.168.30,443,tcp,-,140,120,2,256,4,376,6,normal,-
795093541723298185,10.0.2.61,142.251.36.138,443,tcp,tls,166257,42403,163,23979,158,66382,321,normal,-
9020677984690932354,10.0.2.61,23.195.248.158,443,tcp,tls,242170,24633,68,7690,62,32323,130,normal,-
8668797422321381207,10.0.2.61,104.21.235.46,443,tcp,-,224192,7473,28,2606,28,10079,56,normal,-
6798208115453346643,10.0.2.61,65.9.9.138,80,tcp,http,1226849,32080,196,20787,211,52867,407,normal,-
-888336440492362344,10.0.2.61,141.95.47.55,443,tcp,tls,16904,34016,65,6857,56,40873,121,normal,-
9078226007783608655,10.0.2.61,84.17.61.35,443,tcp,tls,201527,20027,54,5877,53,25904,107,normal,-
-3519057354038914174,10.0.2.61,66.254.114.38,443,tcp,tls,65021,13918,43,6439,44,20357,87,normal,-
3337699897232004452,10.0.2.61,192.124.249.22,80,tcp,http,144382,11142,34,3612,35,14754,69,normal,-
5786045659812872874,10.0.2.61,52.58.202.142,443,tcp,tls,29742,15166,50,5268,46,20434,96,normal,-
-8654432887104392003,10.0.2.61,35.244.174.68,443,tcp,tls,1368,15952,38,4382,38,20334,76,normal,-
-4372816466663414998,10.0.2.61,224.0.0.251,5353,udp,-,0,0,0,549,3,549,3,normal,-
5424790665682752464,10.0.2.61,13.107.21.200,443,tcp,tls,264378,42911,80,8746,72,51657,152,normal,-
-4067890164073046146,10.0.2.61,8.8.8.8,53,udp,dns,2935319,222574,1327,122917,1333,345491,2660,normal,-
687592178259160120,10.0.2.61,192.229.221.95,80,tcp,http,1318157,47918,238,34146,245,82064,483,normal,-
3035383246959676472,10.0.2.61,104.64.175.239,443,tcp,tls,129991,15833,49,5248,50,21081,99,normal,-
4533159737059981602,10.0.2.61,95.100.146.72,80,tcp,-,1249879,46016,208,27366,208,73382,416,normal,-
5232886419766620508,10.0.2.61,178.250.0.163,443,tcp,tls,21300,18750,44,5064,38,23814,82,normal,-
3475174394951638832,10.0.2.61,23.20.85.144,443,tcp,tls,190514,24892,76,9885,74,34777,150,normal,-
-6197535563406838396,10.0.2.61,64.210.135.115,443,tcp,tls,16294,63773,85,7482,63,71255,148,normal,-
5054774454180196286,10.0.2.61,65.9.95.33,443,tcp,tls,222351,55190,119,19421,121,74611,240,normal,-
-1796067538673484314,10.0.2.61,77.75.79.222,443,tcp,tls,345236,250302,246,20030,192,270332,438,normal,-
8832425674269767644,10.0.2.61,162.19.138.119,443,tcp,tls,13180,12566,28,3588,28,16154,56,normal,-
-7096656103481282847,10.0.2.61,104.16.182.15,443,tcp,tls,351806,376154,370,37309,327,413463,697,normal,-
-2848211077250044054,10.0.2.61,141.95.47.54,443,tcp,tls,203056,13246,52,6772,50,20018,102,normal,-
-8515159926664881344,10.0.2.61,157.240.30.54,443,tcp,tls,319863,38004,137,19504,131,57508,268,normal,-
-1390452725277718619,10.0.2.61,142.251.36.131,443,tcp,tls,171327,25562,72,8690,68,34252,140,normal,-
-7163052790920480995,10.0.2.61,65.9.95.57,443,tcp,tls,221144,50346,103,15528,101,65874,204,normal,-
-7278886114748656031,10.0.2.61,5.9.34.14,443,tcp,tls,558997,39671,145,44659,144,84330,289,normal,-
-2456847465321227776,10.0.2.61,142.251.36.142,443,tcp,tls,1059009,116510,186,16451,162,132961,348,normal,-
8452287082429999510,10.0.2.61,142.251.36.66,443,udp,-,18122,136009,210,42900,140,178909,350,normal,-
-4330921242473263857,10.0.2.61,142.251.36.130,443,udp,-,17550,52048,75,22765,65,74813,140,normal,-
4331934758658704779,10.0.2.61,151.101.106.91,443,tcp,tls,9053,22230,36,4693,35,26923,71,normal,-
5226775315852433515,10.0.2.61,140.82.121.3,443,tcp,tls,328228,1069350,896,70634,800,1139984,1696,normal,-
-5898052070119070036,10.0.2.61,142.251.37.110,443,tcp,tls,2665,108384,152,14064,119,122448,271,normal,-
6701886873986095027,10.0.2.61,65.9.94.179,443,tcp,-,110440,7481,21,2314,25,9795,46,normal,-
-6927183804458953147,10.0.2.61,140.82.112.21,443,tcp,tls,313316,16190,68,16046,70,32236,138,normal,-
5072297485839921989,10.0.2.61,34.107.221.82,80,tcp,-,686155,7116,90,7123,92,14239,182,normal,-
4579861994110789056,10.0.2.61,142.251.36.65,443,udp,-,720,28915,35,6728,20,35643,55,normal,-
-2510270744345449723,10.0.2.61,142.250.27.157,443,tcp,tls,171779,26582,80,8803,72,35385,152,normal,-
2362002453907742183,10.0.2.61,77.75.76.209,443,tcp,tls,52464,121474,116,6704,80,128178,196,normal,-
1197777587259362875,10.0.2.61,52.17.35.147,443,tcp,tls,64008,16368,35,4548,36,20916,71,normal,-
-7192058073900280363,10.0.2.61,34.98.74.57,443,tcp,tls,13772,24500,82,8456,70,32956,152,normal,-
1524324664606950695,10.0.2.61,95.100.146.11,443,tcp,tls,362930,25872,76,11710,71,37582,147,normal,-
7881977895143721698,10.0.2.61,54.205.105.217,443,tcp,tls,123222,14856,42,6444,44,21300,86,normal,-
7068868327222861570,52.39.49.137,10.0.2.61,60752,tcp,-,0,286,4,290,4,576,8,normal,-
-1465980625218157359,10.0.2.61,205.185.208.85,443,tcp,tls,20460,80954,76,4796,46,85750,122,normal,-
-933816415176036701,10.0.2.61,77.75.78.126,443,tcp,tls,341974,13700,42,4154,42,17854,84,normal,-
-2376490670851782316,10.0.2.61,146.75.116.157,443,tcp,tls,511656,33735,71,7197,60,40932,131,normal,-
-5107128346817547822,10.0.2.61,142.251.36.97,443,tcp,tls,667101,50524,98,9876,98,60400,196,normal,-
-4483380896248127845,10.0.2.61,157.240.30.35,443,tcp,tls,1383,24770,85,10883,78,35653,163,normal,-
5032030577798008975,10.0.2.61,185.86.139.101,443,tcp,tls,20728,11226,34,4104,32,15330,66,normal,-
-2327889298464592398,10.0.2.61,62.109.141.196,443,tcp,tls,96547,31398,86,12601,72,43999,158,normal,-
-2999790558475769499,10.0.2.61,35.241.9.150,443,tcp,-,225966,1092,16,1146,16,2238,32,normal,-
7113643167186332348,10.0.2.61,52.203.22.151,443,tcp,tls,344136,15090,46,5066,44,20156,90,normal,-
-4978661468038706750,10.0.2.61,151.101.66.91,443,tcp,tls,346828,44799,89,7447,78,52246,167,normal,-
4282880695616329435,10.0.2.61,104.96.131.246,80,tcp,http,231372,5934,34,2830,36,8764,70,normal,-
-7156585046812379607,10.0.2.61,104.17.74.206,443,tcp,tls,340974,8508,34,3864,34,12372,68,normal,-
-4098191914992537457,10.0.2.61,162.159.152.17,443,tcp,tls,684,14276,32,4072,32,18348,64,normal,-
-315118289593705051,10.0.2.61,34.195.71.137,443,tcp,tls,110948,32705,136,50460,139,83165,275,normal,-
4906545717792169269,10.0.2.61,65.9.95.94,443,tcp,tls,515191,24321,65,7114,61,31435,126,normal,-
-584713959323731055,10.0.2.61,146.75.122.248,443,tcp,tls,812579,618880,591,33337,374,652217,965,normal,-
-4232941486101753731,10.0.2.61,185.89.210.46,443,tcp,tls,21682,11686,28,4442,24,16128,52,normal,-
7648483500619405133,10.0.2.61,142.251.37.106,443,tcp,tls,511462,19386,55,5799,55,25185,110,normal,-
3457182230900014975,10.0.2.61,142.251.36.99,443,tcp,tls,19423,94005,119,10155,100,104160,219,normal,-
-5021476486839299374,10.0.2.61,35.188.42.15,443,tcp,tls,530052,40308,140,19235,134,59543,274,normal,-
-3747285075302400934,10.0.2.61,66.254.114.41,443,tcp,tls,62127,147990,145,10758,95,158748,240,normal,-
-6062376196648671317,10.0.2.61,142.251.36.98,443,tcp,tls,561186,30710,84,9042,84,39752,168,normal,-
-6168337647220171221,10.0.2.61,65.9.94.11,443,tcp,tls,230622,16116,48,5830,50,21946,98,normal,-
-5666882373423853224,10.0.2.61,142.251.36.67,443,udp,-,27005,74778,120,27722,110,102500,230,normal,-
4751872568118656778,10.0.2.61,65.9.95.119,443,tcp,tls,348412,40653,86,8650,81,49303,167,normal,-
-4694130746041182282,10.0.2.61,65.9.95.11,443,tcp,tls,607,20947,40,4596,40,25543,80,normal,-
-7451396619443327239,10.0.2.61,13.248.245.213,443,tcp,tls,342308,14462,44,5074,44,19536,88,normal,-
8379343604369363479,10.0.2.61,63.32.242.157,443,tcp,tls,341816,14336,46,5198,46,19534,92,normal,-
-1680049468060254737,10.0.2.61,34.160.144.191,443,tcp,-,223966,1120,16,1202,16,2322,32,normal,-
-5540597329012180713,10.0.2.61,199.232.18.91,443,tcp,tls,214,3284,8,1614,10,4898,18,normal,-
-7330911862600091827,10.0.2.61,188.114.96.3,443,tcp,tls,340770,9124,36,3830,36,12954,72,normal,-
3691656204481191318,10.0.2.61,178.250.1.13,443,tcp,tls,20540,9826,34,3566,34,13392,68,normal,-
913497113978339682,10.0.2.61,185.80.39.216,443,tcp,tls,4250,16946,36,5082,38,22028,74,normal,-
-7963191073847395723,10.0.2.61,18.156.0.31,443,tcp,tls,61484,15318,38,4558,36,19876,74,normal,-
8513826142336543671,10.0.2.61,31.30.189.12,443,tcp,tls,348900,1028952,758,42366,669,1071318,1427,normal,-
7260101976103656012,10.0.2.61,142.251.36.86,443,udp,-,6310,626467,495,19906,138,646373,633,normal,-
-4177243839977293978,10.0.2.61,178.250.0.162,443,tcp,tls,20676,9898,36,4552,36,14450,72,normal,-
-8785341895580737878,10.0.2.61,23.195.248.219,443,tcp,tls,268912,1633544,1267,53132,693,1686676,1960,normal,-
-7327218789434338864,10.0.2.61,142.251.36.67,443,tcp,tls,171638,18908,56,6173,52,25081,108,normal,-
-9093619625216086945,10.0.2.61,34.117.237.239,443,tcp,-,384708,14702,59,5888,60,20590,119,normal,-
-4843220533264980677,10.0.2.61,142.251.37.97,443,udp,-,847,21986,27,6537,25,28523,52,normal,-
3702626267702899337,10.0.2.61,142.251.36.136,443,udp,-,2331,680859,521,27304,194,708163,715,normal,-
-3446791930807062182,10.0.2.61,142.251.36.97,443,udp,-,21194,103581,110,18174,75,121755,185,normal,-
6186468688399610446,10.0.2.61,34.249.157.78,443,tcp,tls,122636,12554,38,4406,38,16960,76,normal,-
-166698983865755720,10.0.2.61,194.228.31.74,443,tcp,tls,183912,745407,645,44433,517,789840,1162,normal,-
4776643893349137831,10.0.2.61,66.254.114.156,443,tcp,tls,11588,8234,20,2438,22,10672,42,normal,-
6516876628515045292,10.0.2.61,65.9.94.227,443,tcp,-,111706,77163,78,4776,50,81939,128,normal,-
-5252775520201372659,10.0.2.61,140.82.121.5,443,tcp,tls,340694,60810,274,174932,268,235742,542,normal,-
-3687900313740378983,10.0.2.61,77.75.79.234,443,tcp,tls,367724,46696,78,7445,65,54141,143,normal,-
-7983167710813612783,10.0.2.61,77.75.78.30,443,tcp,tls,93273,206861,319,32396,251,239257,570,normal,-
-292383092687257516,10.0.2.61,104.21.235.45,443,tcp,tls,340592,13766,38,3938,38,17704,76,normal,-
-4237715654108584396,10.0.2.61,142.251.37.110,443,udp,-,10901,53068,188,173357,214,226425,402,normal,-
6312553928450631288,10.0.2.61,70.42.32.95,443,tcp,tls,15358,8862,26,3694,26,12556,52,normal,-
2088340384365359165,10.0.2.61,185.235.87.41,443,tcp,tls,20860,9778,30,3788,28,13566,58,normal,-
-3205079735526894595,10.0.2.61,142.251.36.72,443,tcp,tls,3117,560833,459,19493,234,580326,693,normal,-
7009138964879798006,10.0.2.61,188.68.250.242,443,tcp,tls,19948,46044,56,4480,38,50524,94,normal,-
3947278835975010076,10.0.2.61,143.244.32.123,443,tcp,tls,370,18074,30,3276,30,21350,60,normal,-
-1572254280295147965,10.0.2.61,185.102.217.108,443,tcp,tls,11312,761519,569,21485,310,783004,879,normal,-
-4345172052029334167,10.0.2.61,65.9.99.47,443,tcp,tls,446537,372910,406,34883,374,407793,780,normal,-
-7438019448491131396,10.0.2.61,95.100.146.27,80,tcp,-,5233,1067,11,1161,14,2228,25,normal,-
9083004626601770798,10.0.2.61,185.255.84.153,443,tcp,tls,42258,16256,40,4548,40,20804,80,normal,-
-819747473195987414,10.0.2.61,104.96.92.79,443,tcp,tls,241100,12906,42,4808,38,17714,80,normal,-
-796511049310742136,10.0.2.61,142.251.36.142,443,udp,-,50319,794056,920,434712,729,1228768,1649,normal,-
-8535882164487773910,10.0.2.61,104.244.42.69,443,tcp,tls,336990,9580,36,4968,38,14548,74,normal,-
7195709967443525562,10.0.2.61,87.249.131.98,443,tcp,tls,33135,1966645,1449,47225,688,2013870,2137,normal,-
-1681200423615842982,10.0.2.61,95.100.146.17,443,tcp,tls,94994,3764956,2799,92839,1368,3857795,4167,normal,-
-2766947449908998774,10.0.2.61,54.239.38.253,443,tcp,tls,495551,50365,148,27490,149,77855,297,normal,-
-7994749098761151705,10.0.2.61,52.39.49.137,443,tcp,-,1034,832,12,672,10,1504,22,normal,-
-6748006209775255536,10.0.2.61,104.19.188.97,443,tcp,tls,515610,274521,253,13935,163,288456,416,normal,-
-6914919628465690338,10.0.2.61,13.224.195.78,443,tcp,tls,195078,14572,36,3752,36,18324,72,normal,-
8471352060161093554,10.0.2.61,188.114.97.3,443,udp,-,320,18769,27,6935,25,25704,52,normal,-
3121136418140529178,10.0.2.61,91.228.74.168,443,tcp,tls,123932,10896,40,5298,40,16194,80,normal,-
2175669279228834690,10.0.2.61,65.9.95.67,443,tcp,-,223988,1120,16,1202,16,2322,32,normal,-
6439899461041017502,10.0.2.61,142.251.36.100,443,udp,-,200530,1403091,1826,287346,1125,1690437,2951,normal,-
-2302622764997819550,10.0.2.61,8.253.240.113,443,tcp,tls,12210,1417302,998,28148,472,1445450,1470,normal,-
8798695763280432125,10.0.2.61,172.67.11.176,443,tcp,tls,13739,39650,69,7748,64,47398,133,normal,-
-6551975857534429338,10.0.2.61,77.75.79.165,443,tcp,tls,342106,14600,48,5690,48,20290,96,normal,-
-943757579286751757,10.0.2.61,35.244.143.131,443,udp,-,13494,218537,216,29995,126,248532,342,normal,-
3868798242709409189,10.0.2.61,35.186.224.25,80,tcp,-,127153,1472,22,2151,25,3623,47,normal,-
8476518731048043322,10.0.2.61,146.75.116.193,443,tcp,tls,342016,20088,48,5064,44,25152,92,normal,-
8191861126127936955,10.0.2.61,52.17.208.199,443,tcp,tls,21138,13448,28,4232,28,17680,56,normal,-
-7896170332839445557,10.0.2.61,192.124.249.41,80,tcp,-,65229,16111,41,5283,48,21394,89,normal,-
4609785072407836217,10.0.2.61,162.159.136.232,443,udp,-,1320,22396,48,45660,56,68056,104,normal,-
-7095392489896195509,10.0.2.61,65.9.95.80,443,tcp,tls,340882,17062,44,4912,44,21974,88,normal,-
-849934328334964083,10.0.2.61,142.250.27.157,443,udp,-,2227,19325,51,11728,33,31053,84,normal,-
-4121003917867911508,10.0.2.61,162.243.189.2,443,tcp,tls,100870,9092,32,3350,30,12442,62,normal,-
6429087647928174189,10.0.2.61,23.195.249.65,443,tcp,tls,240818,16286,44,4870,44,21156,88,normal,-
1910106363914727865,10.0.2.61,65.9.94.75,443,tcp,tls,5637,346019,384,28993,279,375012,663,normal,-
5540152951367643351,10.0.2.61,23.75.66.132,443,tcp,tls,31460,44974,60,4704,42,49678,102,normal,-
-4761463000597521521,10.0.2.61,185.64.190.80,443,tcp,tls,343892,12844,42,5056,42,17900,84,normal,-
-2977235209087178509,10.0.2.61,194.228.31.76,443,tcp,tls,26026,339398,252,14252,202,353650,454,normal,-
-8240491879506698050,10.0.2.61,172.67.12.188,443,tcp,tls,3972,35178,48,4816,40,39994,88,normal,-
-7256472822346311849,10.0.2.61,54.155.246.232,443,tcp,tls,27168,154464,212,53832,162,208296,374,normal,-
-6728944955516498770,10.0.2.61,23.195.248.142,443,tcp,tls,354903,81716,164,44470,143,126186,307,normal,-
728963097905571838,10.0.2.61,104.244.42.131,443,tcp,tls,336092,9902,40,5100,40,15002,80,normal,-
-7768727028509845622,10.0.2.61,151.101.194.206,443,tcp,tls,53591,50118,102,11797,104,61915,206,normal,-
8098547309093034749,10.0.2.61,34.248.37.18,443,tcp,tls,32694,44618,92,13477,93,58095,185,normal,-
5959091217887431298,10.0.2.61,65.9.95.111,443,tcp,tls,278807,31131,78,8765,75,39896,153,normal,-
5687913954593295995,10.0.2.61,87.249.131.101,443,tcp,tls,11474,1098028,786,41276,692,1139304,1478,normal,-
-1882079935988257317,10.0.2.61,142.251.36.132,443,tcp,tls,51043,33718,91,11214,82,44932,173,normal,-
2811705802385780932,10.0.2.61,65.9.94.192,443,tcp,tls,2376,1367606,1029,40448,564,1408054,1593,normal,-
-9202939231463149013,10.0.2.61,34.232.92.67,443,tcp,tls,1624,11354,30,4580,26,15934,56,normal,-
-8375768135366899257,10.0.2.61,34.120.208.123,443,tcp,tls,445872,67684,413,140386,353,208070,766,normal,-
-4279974291506333319,10.0.2.61,77.75.76.74,443,tcp,tls,56176,19598,47,5772,50,25370,97,normal,-
3646303858867326320,10.0.2.61,23.195.249.33,443,tcp,tls,27504,12246,36,4452,32,16698,68,normal,-
412809247740862255,10.0.2.61,77.75.77.235,443,tcp,tls,23620,13336,36,4182,36,17518,72,normal,-
6135495748052025298,10.0.2.61,142.250.102.157,443,tcp,tls,1063,19967,56,6672,50,26639,106,normal,-
-40921790408068500,10.0.2.61,104.19.136.78,443,tcp,tls,1112,20310,42,5336,36,25646,78,normal,-
-8534849027429965069,10.0.2.61,77.75.77.234,443,tcp,tls,52214,82010,112,9382,85,91392,197,normal,-
5220910118010684309,10.0.2.61,194.228.31.70,443,tcp,tls,127740,1216410,931,51852,501,1268262,1432,normal,-
4686568537076096815,10.0.2.61,34.160.111.29,443,tcp,tls,2128,10978,32,4146,32,15124,64,normal,-
2966035376945234824,10.0.2.61,185.152.65.26,443,tcp,tls,33313,39621,63,6420,55,46041,118,normal,-
-9004326339166588503,10.0.2.61,95.100.146.83,443,tcp,tls,180626,10684,40,4342,38,15026,78,normal,-
2659248975395701441,10.0.2.61,188.40.16.209,443,tcp,tls,346386,24137,75,7415,75,31552,150,normal,-
646214082970053413,10.0.2.61,23.195.249.164,443,tcp,tls,16338,21836,38,6782,30,28618,68,normal,-
-9103757016725771837,10.0.2.61,95.100.146.50,443,tcp,tls,179448,11096,44,4450,40,15546,84,normal,-
-2604093995297237397,10.0.2.61,35.244.143.131,443,tcp,tls,726083,167937,214,16741,158,184678,372,normal,-
4947552883126942175,10.0.2.61,162.159.153.247,443,tcp,tls,60016,57720,88,9079,82,66799,170,normal,-
2789701396301199363,10.0.2.61,23.195.248.24,443,tcp,tls,240772,14170,46,4896,44,19066,90,normal,-
8670093908299527172,10.0.2.61,20.119.174.243,443,tcp,tls,19452,16612,32,5027,34,21639,66,normal,-
-8443032983922731123,10.0.2.61,2.16.2.17,443,tcp,tls,270279,16587,66,6679,60,23266,126,normal,-
-1182987806928673030,10.0.2.61,151.101.194.91,443,tcp,tls,234686,33516,64,10326,58,43842,122,normal,-
3598151540481990297,10.0.2.61,151.101.192.233,443,tcp,tls,341032,12514,38,3972,36,16486,74,normal,-
5646643291640373024,10.0.2.61,65.9.95.76,443,tcp,tls,95432,21153,47,5133,45,26286,92,normal,-
2688203471324847486,10.0.2.61,45.57.90.1,443,tcp,tls,70433,423755,367,25270,332,449025,699,normal,-
-8509803651140800780,10.0.2.61,93.184.221.225,443,tcp,tls,53672,39348,97,10893,94,50241,191,normal,-
5308408126298459207,10.0.2.61,104.18.43.158,443,tcp,tls,353795,14906,58,6625,55,21531,113,normal,-
3417398855974467662,10.0.2.61,35.241.13.32,443,tcp,tls,1620,276531,226,10422,129,286953,355,normal,-
773667504217083399,10.0.2.61,34.241.22.200,443,tcp,tls,22489,16941,40,6600,38,23541,78,normal,-
5651307208428672746,10.0.2.61,34.253.52.2,443,tcp,tls,342818,13112,46,5028,44,18140,90,normal,-
7608162147111866980,10.0.2.61,151.101.65.140,443,tcp,tls,371240,2781054,2024,141324,1952,2922378,3976,normal,-
8647544960450374896,10.0.2.61,216.239.32.36,443,tcp,tls,185234,31425,80,9116,79,40541,159,normal,-
-6083951259514417985,10.0.2.61,65.9.95.13,443,tcp,tls,219014,19474,56,8410,58,27884,114,normal,-
-672838310647898280,10.0.2.61,104.22.2.110,443,tcp,tls,1041,10156,31,4312,31,14468,62,normal,-
8594350827467837674,10.0.2.61,104.22.19.181,443,tcp,tls,61956,134694,154,9772,92,144466,246,normal,-
-3041303011915459931,10.0.2.61,13.107.226.44,443,tcp,tls,21520,56600,64,5168,46,61768,110,normal,-
6341353398642513654,10.0.2.61,35.164.56.167,443,tcp,tls,190152,9066,34,4640,30,13706,64,normal,-
-5103917100927871308,10.0.2.61,65.9.95.93,443,tcp,tls,23909,24761,71,26870,67,51631,138,normal,-
-2979548638827285774,10.0.2.61,65.9.95.127,443,tcp,tls,342126,51336,70,5224,52,56560,122,normal,-
77537654481774122,10.0.2.61,104.19.187.97,443,tcp,tls,39749,52865,85,8723,69,61588,154,normal,-
-6399954608415969858,10.0.2.61,172.64.144.98,443,tcp,tls,357178,31281,116,37344,112,68625,228,normal,-
9082687302747496642,10.0.2.61,54.220.16.194,443,tcp,tls,21954,14030,28,4236,30,18266,58,normal,-
-165092619422251696,10.0.2.61,209.140.135.138,443,tcp,tls,1106,6536,12,1722,12,8258,24,normal,-
4866503864177638994,10.0.2.61,141.95.47.56,443,tcp,tls,53274,84204,108,9975,99,94179,207,normal,-
-1539118285726578887,10.0.2.61,65.9.95.68,443,tcp,tls,49696,12294,36,4162,34,16456,70,normal,-
742941350645252085,10.0.2.61,31.30.189.13,443,tcp,tls,232596,14114,46,4704,48,18818,94,normal,-
-7362551736020610499,10.0.2.61,104.22.25.150,443,tcp,tls,182102,13246,35,3772,36,17018,71,normal,-
-5631526382169356164,10.0.2.61,95.100.146.34,443,tcp,tls,20900,225418,198,12770,120,238188,318,normal,-
7919446576636900528,10.0.2.61,194.228.31.71,443,tcp,tls,106507,1485596,1104,51381,624,1536977,1728,normal,-
-6950375115881271081,10.0.2.61,3.123.222.171,443,tcp,tls,94459,145096,149,12000,133,157096,282,normal,-
-2243734826368313272,10.0.2.61,198.47.127.20,443,tcp,tls,343710,12822,40,5206,40,18028,80,normal,-
-1683929630212337952,10.0.2.61,52.58.30.104,443,tcp,tls,344032,16122,56,5582,48,21704,104,normal,-
-6147090059184373987,10.0.2.61,104.22.18.181,443,tcp,tls,464,8176,22,2812,22,10988,44,normal,-
5151065237376893161,10.0.2.61,54.73.148.110,443,tcp,tls,546,9826,22,2812,22,12638,44,normal,-
5265516599134641169,10.0.2.61,146.59.30.104,443,tcp,tls,24506,20528,46,4918,40,25446,86,normal,-
7160567274515538039,10.0.2.61,65.9.95.56,443,tcp,tls,33356,349244,268,10618,146,359862,414,normal,-
-3153546260025842385,10.0.2.61,142.251.36.134,443,tcp,tls,303262,12584,36,3830,36,16414,72,normal,-
-102003238213327873,10.0.2.61,65.9.92.135,443,tcp,tls,224572,390888,296,16900,250,407788,546,normal,-
-2449951563962137817,10.0.2.61,146.59.30.108,443,tcp,tls,50700,20392,44,4898,38,25290,82,normal,-
-2248712455201716397,10.0.2.61,52.94.236.45,443,tcp,tls,218394,36932,222,239942,224,276874,446,normal,-
-629364643572757717,10.0.2.61,194.228.31.71,80,tcp,http,25848,1923,16,1266,16,3189,32,normal,-
799591870116789045,10.0.2.61,65.9.95.97,443,tcp,tls,181466,169618,146,6522,74,176140,220,normal,-
-1062126211416012479,10.0.2.61,205.185.208.79,443,tcp,tls,341476,13634,40,4046,40,17680,80,normal,-
-5252533901205170419,10.0.2.61,65.9.95.113,443,tcp,tls,57840,19756,56,13178,50,32934,106,normal,-
-54929304444929505,10.0.2.61,68.219.88.97,443,tcp,tls,21214,15964,38,4220,34,20184,72,normal,-
4881038523734143139,10.0.2.61,65.9.95.121,443,tcp,tls,51872,19856,36,4096,34,23952,70,normal,-
-8553834744149327791,10.0.2.61,206.189.240.8,443,tcp,tls,23546,377718,306,14114,186,391832,492,normal,-
-5268659886436101424,10.0.2.61,15.236.125.10,443,tcp,tls,49762,12014,34,5712,32,17726,66,normal,-
7452121906520601040,10.0.2.61,31.30.190.250,443,tcp,tls,25150,569336,410,13816,212,583152,622,normal,-
2755222998358402150,10.0.2.61,142.251.37.102,443,tcp,tls,2984,14170,36,4664,36,18834,72,normal,-
6138025908219419566,10.0.2.61,37.252.171.53,443,tcp,tls,20760,11828,28,4438,26,16266,54,normal,-
-644849194089571040,10.0.2.61,3.66.141.4,443,tcp,tls,62652,27814,56,6496,56,34310,112,normal,-
5612273301609560029,10.0.2.61,66.211.163.14,443,tcp,tls,104104,17796,42,10962,42,28758,84,normal,-
-4220238015294885320,10.0.2.61,65.9.95.124,443,tcp,tls,25564,349078,270,14824,224,363902,494,normal,-
8331795996883836749,10.0.2.61,91.201.28.211,443,tcp,tls,22708,23970,46,4782,38,28752,84,normal,-
7256410126322798012,10.0.2.61,23.195.249.37,443,tcp,tls,107298,109462,112,8974,58,118436,170,normal,-
9037564930409657840,10.0.2.61,65.9.95.21,443,tcp,tls,50706,155044,130,6264,74,161308,204,normal,-
-4655667373945445218,10.0.2.61,51.105.197.70,443,tcp,tls,11570,10284,38,4150,34,14434,72,normal,-
8747414401733858614,10.0.2.61,77.75.78.36,443,tcp,tls,343798,19468,58,11868,58,31336,116,normal,-
8902381493111195683,10.0.2.61,104.64.173.52,443,tcp,tls,50698,16522,36,4002,34,20524,70,normal,-
2831636472805943935,10.0.2.61,194.228.31.70,80,tcp,http,27108,1920,16,1263,16,3183,32,normal,-
5473212898452110774,10.0.2.61,185.152.64.17,443,tcp,tls,29034,21952,36,4226,36,26178,72,normal,-
-5673028704427126533,10.0.2.61,3.22.184.237,443,tcp,tls,343916,19988,48,5110,46,25098,94,normal,-
5401212808561585885,10.0.2.61,142.251.36.83,443,tcp,tls,57154,12796,50,12684,48,25480,98,normal,-
-4049708246544427460,10.0.2.61,37.252.172.123,443,tcp,tls,21352,11934,30,4658,30,16592,60,normal,-
-7969622364902375117,10.0.2.61,65.9.97.248,443,tcp,tls,339968,43760,62,5204,52,48964,114,normal,-
8375499098600162360,10.0.2.61,65.9.95.23,443,tcp,tls,59136,348674,268,10188,138,358862,406,normal,-
-5319634107675304416,10.0.2.61,67.27.213.122,443,tcp,tls,16988,12516,34,4214,34,16730,68,normal,-
2861387976863130581,10.0.2.61,52.58.209.110,443,tcp,tls,341960,16120,46,6024,46,22144,92,normal,-
5117518646910500615,10.0.2.61,142.251.36.99,443,udp,-,2092,136126,122,16451,55,152577,177,normal,-
-8767155577764366670,10.0.2.61,35.186.224.25,443,udp,-,7644,93292,125,30040,116,123332,241,normal,-
269883690732767021,10.0.2.61,142.251.36.131,443,udp,-,2418,21095,70,15038,49,36133,119,normal,-
3189718125341848386,10.0.2.61,216.239.34.36,443,udp,-,11946,28612,58,16850,43,45462,101,normal,-
-2009576981648452092,10.0.2.61,204.79.197.203,80,tcp,http,17644,5238,12,1666,14,6904,26,normal,-
5049687654511244548,10.0.2.61,142.251.37.99,443,udp,-,12155,43355,73,16172,54,59527,127,normal,-
4420138053275030432,10.0.2.61,142.251.36.118,443,udp,-,544,11964,16,5237,13,17201,29,normal,-
4931200872131441186,10.0.2.61,142.251.37.98,443,udp,-,2612,237473,214,22448,119,259921,333,normal,-
-1785177512338600377,10.0.2.61,35.186.224.17,443,udp,-,4299,17324,39,38420,56,55744,95,normal,-
-3408037879887854964,10.0.2.61,104.16.85.20,443,udp,-,316,10688,20,3662,10,14350,30,normal,-
-2437855498982051817,10.0.2.61,162.159.152.17,443,udp,-,800,16904,30,4520,20,21424,50,normal,-
-6994096471093906363,10.0.2.61,35.244.174.68,443,udp,-,526,15068,16,3806,12,18874,28,normal,-
-4402039780638185677,10.0.2.61,142.251.36.98,443,udp,-,1369,85943,85,11873,58,97816,143,normal,-
-221743519977771677,10.0.2.61,142.251.36.132,443,udp,-,9836,71750,173,52835,125,124585,298,normal,-
-5670575446589606187,10.0.2.61,188.114.96.3,443,udp,-,1852,68730,74,15271,42,84001,116,normal,-
2567020990899801544,10.0.2.61,188.114.96.3,80,tcp,-,16062,540,9,708,12,1248,21,normal,-
-2097536389293303989,10.0.2.61,157.240.30.27,443,udp,-,3781,789548,664,29485,217,819033,881,normal,-
-2851565822049752590,10.0.2.61,142.251.36.74,443,udp,-,4187,35143,52,9629,37,44772,89,normal,-
8493259588785178536,10.0.2.61,65.9.94.80,80,tcp,http,223700,3804,30,2634,32,6438,62,normal,-
-2581485033826863211,10.0.2.61,142.250.27.156,443,udp,-,630,14464,16,3806,12,18270,28,normal,-
-1535045959841231934,10.0.2.61,142.251.36.80,443,udp,-,404,13986,16,3964,14,17950,30,normal,-
1367953323323228124,10.0.2.61,104.21.235.45,443,udp,-,4934,53940,80,11226,44,65166,124,normal,-
-1544743319516408955,10.0.2.61,142.251.36.72,443,udp,-,5818,715962,546,26525,179,742487,725,normal,-
7795832164062510938,10.0.2.61,142.250.102.157,443,udp,-,324,4524,8,3258,6,7782,14,normal,-
-5531721657889794723,10.0.2.61,34.98.74.57,443,udp,-,453,15631,18,5782,19,21413,37,normal,-
7160148975156520915,10.0.2.61,54.73.148.110,80,tcp,-,25264,1348,12,1814,15,3162,27,normal,-
1558333177797157767,10.0.2.61,65.9.92.135,443,udp,-,31573,638723,489,38061,201,676784,690,normal,-
-6854823510654395704,10.0.2.61,157.240.30.54,443,udp,-,20843,991909,845,41350,173,1033259,1018,normal,-
3570442779925213505,10.0.2.61,65.9.94.75,443,udp,-,2931,315892,231,13206,77,329098,308,normal,-
2455429957733783825,10.0.2.61,142.251.36.138,443,udp,-,1958,148954,148,15804,76,164758,224,normal,-
1972871361613475515,10.0.2.61,192.124.249.24,80,tcp,http,34892,20126,32,5202,34,25328,66,normal,-
4472042218396266572,10.0.2.61,65.9.94.192,443,udp,-,246,15752,18,3852,12,19604,30,normal,-
5077735271984953302,10.0.2.61,35.241.13.32,443,udp,-,6328,21317,35,9900,33,31217,68,normal,-
-8450233175663651898,10.0.2.61,146.75.122.251,443,udp,-,2804,17989,26,7276,23,25265,49,normal,-
-8138862697248691080,10.0.2.61,216.239.32.36,443,udp,-,18155,34088,74,16866,56,50954,130,normal,-
2403277766655737725,10.0.2.61,31.30.189.13,443,udp,-,7274,2517296,1860,47842,374,2565138,2234,normal,-
-1493209844015356745,10.0.2.61,142.251.36.134,443,udp,-,862,21959,26,6354,22,28313,48,normal,-
-7712992581879525640,10.0.2.61,54.76.238.75,80,tcp,-,43067,1244,14,1318,17,2562,31,normal,-
6607889299137427815,10.0.2.61,162.159.153.247,443,udp,-,5362,47818,94,38298,96,86116,190,normal,-
-818211083757933046,10.0.2.61,142.251.36.106,443,udp,-,11247,35747,50,13074,48,48821,98,normal,-
-5069046745167076112,10.0.2.61,142.251.36.141,443,udp,-,1440,100452,103,10980,63,111432,166,normal,-
-8272581515362522305,10.0.2.61,31.30.189.12,443,udp,-,3988,7943828,5712,123746,1444,8067574,7156,normal,-
-512052239771018588,10.0.2.61,142.251.36.129,443,udp,-,374,14444,16,4134,16,18578,32,normal,-
-9137924157079660843,10.0.2.61,142.251.37.106,443,udp,-,1076,82544,86,10240,46,92784,132,normal,-
-2823044480237642205,10.0.2.61,157.240.30.35,443,udp,-,12046,26976,73,35374,60,62350,133,normal,-
3088489436576731294,10.0.2.61,142.251.36.78,443,udp,-,501,11869,16,5321,14,17190,30,normal,-
1647097990168487244,10.0.2.61,34.117.157.22,443,udp,-,674,11938,14,3966,14,15904,28,normal,-
6346904953086582455,10.0.2.61,34.160.111.29,443,udp,-,280,9718,12,3630,10,13348,22,normal,-
-5812832041554351356,10.0.2.61,95.100.146.66,80,tcp,http,189540,23260,64,12910,66,36170,130,normal,-
2992368803139394844,10.0.2.61,142.251.36.110,443,udp,-,5250,46942,72,11918,56,58860,128,normal,-
4415559414368887790,10.0.2.61,142.251.37.102,443,udp,-,466,14462,16,3962,14,18424,30,normal,-
-2417127263535717037,10.0.2.61,216.239.32.178,443,udp,-,8004,103086,102,11604,52,114690,154,normal,-
8163832070228518505,10.0.2.61,142.251.36.102,443,udp,-,1788,19674,26,5884,24,25558,50,normal,-
1619414625602417140,10.0.2.61,104.19.136.78,443,udp,-,416,10574,18,3860,12,14434,30,normal,-
-8466722991090870511,10.0.2.61,104.17.33.82,443,udp,-,4766,42432,72,16780,46,59212,118,normal,-
